Team,Number,Name,Position,GP,G,A,PTS,PIM
Air Force Academy 4586.Html,22,Chris Hedden,D,38,8,29,37,37
Air Force Academy 4586.Html,37,Will Gavin,L,38,19,17,36,24
Air Force Academy 4586.Html,4,Luke Rowe,D,35,6,23,29,70
Air Force Academy 4586.Html,26,Clayton Cosentino,F,38,10,18,28,6
Air Force Academy 4586.Html,17,Parker Brown,F,37,8,13,21,27
Air Force Academy 4586.Html,10,Austin Schwartz,F,38,10,9,19,10
Air Force Academy 4586.Html,13,Mason McCormick,F,38,6,9,15,44
Air Force Academy 4586.Html,18,Holt Oliphant,F,38,10,4,14,10
Air Force Academy 4586.Html,82,Andrew DeCarlo,F,32,5,9,14,12
Air Force Academy 4586.Html,64,Brendan Gibbons,R,33,7,5,12,14
Air Force Academy 4586.Html,6,Owen Baumgartner,D,24,4,6,10,12
Air Force Academy 4586.Html,27,Luke Robinson,D,38,2,7,9,32
Air Force Academy 4586.Html,44,William Staring,D,33,1,8,9,20
Air Force Academy 4586.Html,7,Brian Adams,L,30,2,6,8,4
Air Force Academy 4586.Html,24,Nathan Horn,F,33,3,4,7,12
Air Force Academy 4586.Html,16,Sam Brennan,D,36,3,4,7,16
Air Force Academy 4586.Html,15,Owen Dubois,F,30,4,2,6,6
Air Force Academy 4586.Html,19,Nicholas Remissong,C,34,1,5,6,19
Air Force Academy 4586.Html,9,Lucas Coon,F,11,3,2,5,2
Air Force Academy 4586.Html,20,Nolan Cunningham,D,26,0,5,5,2
Air Force Academy 4586.Html,28,Mitchell Digby,D,27,2,1,3,11
Air Force Academy 4586.Html,14,Jacob Marti,F,15,1,1,2,21
Air Force Academy 4586.Html,11,Samuel Jacobs,F,1,0,0,0,0
Air Force Academy 4586.Html,35,Carter Clafton,G,2,0,0,0,0
Air Force Academy 4586.Html,29,Jasper Lester,D,2,0,0,0,0
Air Force Academy 4586.Html,12,James Callahan,D,2,0,0,0,0
Air Force Academy 4586.Html,51,Maiszon Balboa,G,5,0,0,0,0
Air Force Academy 4586.Html,8,Ethan Ullrick,R,7,0,0,0,15
Air Force Academy 4586.Html,1,Guy Blessing,G,38,0,0,0,0
Albertus Magnus College 12798.Html,26,Tyler Ignazzitto,F,25,3,17,20,12
Albertus Magnus College 12798.Html,37,Sam Anderson,F,25,11,8,19,12
Albertus Magnus College 12798.Html,12,Tim Manning,F,25,7,10,17,8
Albertus Magnus College 12798.Html,22,Cameron Weitzman,F,25,7,9,16,12
Albertus Magnus College 12798.Html,4,Zane Kindrachuk,F,19,7,7,14,2
Albertus Magnus College 12798.Html,21,Caden Pattison,F,24,6,8,14,54
Albertus Magnus College 12798.Html,5,Harley Michaels,D,25,1,12,13,27
Albertus Magnus College 12798.Html,25,J.J. Berdal,D,23,5,7,12,20
Albertus Magnus College 12798.Html,23,Gustav Muller,F,22,4,7,11,20
Albertus Magnus College 12798.Html,2,Charles Lavoie,F,24,4,7,11,22
Albertus Magnus College 12798.Html,14,Will Lavigne,D,25,4,7,11,14
Albertus Magnus College 12798.Html,6,Connor Bertamini,D,23,3,7,10,22
Albertus Magnus College 12798.Html,28,Zeth Kindrachuk,L,23,8,1,9,14
Albertus Magnus College 12798.Html,7,Sam Witt,D,22,1,7,8,19
Albertus Magnus College 12798.Html,17,Paden Hicks,C,17,5,1,6,8
Albertus Magnus College 12798.Html,8,Robert Barrasso,L,15,1,5,6,12
Albertus Magnus College 12798.Html,18,Kyle Dann,F,23,2,3,5,9
Albertus Magnus College 12798.Html,11,Bailey Kirwin,C,18,1,3,4,4
Albertus Magnus College 12798.Html,10,Eric Chamandy,D,20,1,3,4,7
Albertus Magnus College 12798.Html,13,Aidan Patterson,F,12,2,0,2,2
Albertus Magnus College 12798.Html,20,Jeremy Tremblay,R,6,1,1,2,2
Albertus Magnus College 12798.Html,3,Ryan Herpy,D,25,1,1,2,6
Albertus Magnus College 12798.Html,30,Logan Bateman,G,23,0,2,2,2
Albertus Magnus College 12798.Html,9,Kyler Campbell,F,1,0,0,0,0
Albertus Magnus College 12798.Html,16,Ryan Colwell,R,1,0,0,0,0
Albertus Magnus College 12798.Html,1,Shane Peremba,G,1,0,0,0,0
Albertus Magnus College 12798.Html,39,Lucas Ehrlich,G,2,0,0,0,0
Albertus Magnus College 12798.Html,99,Carson Ironside,G,3,0,0,0,0
Albertus Magnus College 12798.Html,19,Spencer Silver,L,5,0,0,0,2
Albertus Magnus College 12798.Html,24,Nick Durajlija,D,10,0,0,0,15
American International College 4631.Html,9,Dustin Manz,F,39,7,24,31,28
American International College 4631.Html,11,Julius Janhonen,C,40,5,19,24,27
American International College 4631.Html,19,Jordan Biro,L,39,7,16,23,4
American International College 4631.Html,21,John Lundy,L,26,14,8,22,25
American International College 4631.Html,28,Alfred Lindberg,C,20,11,11,22,6
American International College 4631.Html,7,Brian Kramer,D,35,10,12,22,35
American International College 4631.Html,25,Alexander Malinowski,C,27,9,11,20,23
American International College 4631.Html,55,Brett Rylance,F,38,6,14,20,31
American International College 4631.Html,44,Austen Long,F,38,8,8,16,27
American International College 4631.Html,24,Blake Wells,F,32,4,6,10,12
American International College 4631.Html,4,Brett Callahan,D,37,4,6,10,10
American International College 4631.Html,17,Oscar Geschwind,C,32,2,8,10,8
American International College 4631.Html,2,Nico Somerville,D,40,4,5,9,12
American International College 4631.Html,5,Tomi Leppanen,D,40,3,6,9,39
American International College 4631.Html,37,Evan Stella,D,40,3,5,8,37
American International College 4631.Html,61,Casey McDonald,R,31,4,3,7,22
American International College 4631.Html,3,Logan Jenuwine,C,23,1,6,7,12
American International College 4631.Html,39,Dario Beljo,F,16,2,4,6,12
American International College 4631.Html,6,Matt Rickard,D,25,2,4,6,8
American International College 4631.Html,22,Timofei Khokhlachev,L,12,3,2,5,14
American International College 4631.Html,27,Josh Barnes,C,22,3,2,5,2
American International College 4631.Html,23,Theo Angesved,D,15,2,2,4,2
American International College 4631.Html,15,Casper Soderling,D,12,1,3,4,2
American International College 4631.Html,8,Hunter Jones,F,14,0,4,4,4
American International College 4631.Html,13,Grayson Dietrich,F,19,2,1,3,18
American International College 4631.Html,9,Hunter Longhi,F,8,1,2,3,0
American International College 4631.Html,16,Andrew Amousse,L,10,1,0,1,4
American International College 4631.Html,18,Akseli Pennanen,F,7,0,1,1,0
American International College 4631.Html,30,Cole Hudson,G,1,0,0,0,0
American International College 4631.Html,26,Jake Sacratini,F,2,0,0,0,0
American International College 4631.Html,14,Douglas Andersson,R,7,0,0,0,6
American International College 4631.Html,1,Alexander Aslanidis,G,9,0,0,0,0
American International College 4631.Html,29,Darwin Lakoduk,L,12,0,0,0,4
American International College 4631.Html,34,Nils Wallstrom,G,33,0,0,0,0
Amherst College 4632.Html,25,Ryan Tucker,F,25,16,12,28,23
Amherst College 4632.Html,9,Joshua Burke,F,25,10,14,24,2
Amherst College 4632.Html,20,Benjamin Kuzma,R,20,12,7,19,10
Amherst College 4632.Html,12,Tyler Bourque,F,25,4,12,16,6
Amherst College 4632.Html,15,Zachary Murray,F,22,6,8,14,14
Amherst College 4632.Html,21,Vincent Velocci,C,24,5,9,14,12
Amherst College 4632.Html,24,Quinton Fox,F,25,5,9,14,2
Amherst College 4632.Html,2,Ben Ritter,D,25,4,7,11,16
Amherst College 4632.Html,41,Matthew Toporowski,F,15,4,6,10,17
Amherst College 4632.Html,3,Matt VanderVort,F,21,2,8,10,6
Amherst College 4632.Html,4,Zachary Jesse,D,25,1,8,9,8
Amherst College 4632.Html,19,Bobby Luca,F,23,3,5,8,2
Amherst College 4632.Html,28,Connor Guest,F,23,5,2,7,10
Amherst College 4632.Html,18,Andrew Carmody,D,20,3,4,7,6
Amherst College 4632.Html,10,Max Thiessen,D,23,1,5,6,4
Amherst College 4632.Html,7,Jacob Pohl,F,16,2,2,4,0
Amherst College 4632.Html,27,Michael Gallagher,D,24,1,3,4,4
Amherst College 4632.Html,5,Spencer Kimball,D,25,1,3,4,4
Amherst College 4632.Html,16,Connor McGinnis,D,21,0,3,3,27
Amherst College 4632.Html,11,Alton Machen,F,14,0,2,2,19
Amherst College 4632.Html,13,Ryan Corcoran,C,22,1,0,1,8
Amherst College 4632.Html,14,Sergei Leonov,F,1,0,1,1,2
Amherst College 4632.Html,6,Oscar Smink,F,8,0,1,1,2
Amherst College 4632.Html,1,Connor Leslie,G,12,0,1,1,0
Amherst College 4632.Html,30,Andrew Palena,G,3,0,0,0,0
Amherst College 4632.Html,8,Quinton Gove,D,6,0,0,0,0
Amherst College 4632.Html,33,Alex Wisco,G,14,0,0,0,0
Anna Maria College 12575.Html,18,Braeden McKinnon,F,25,13,8,21,18
Anna Maria College 12575.Html,28,Guillaume Coulombe,C,25,11,10,21,18
Anna Maria College 12575.Html,27,Derek Raposo,D,25,8,11,19,34
Anna Maria College 12575.Html,12,Brandon Della Paolera,F,24,8,8,16,12
Anna Maria College 12575.Html,25,Matthew Gilbert,R,25,10,5,15,37
Anna Maria College 12575.Html,10,Pearce Baker,D,25,3,12,15,16
Anna Maria College 12575.Html,15,Max Wennerberg,L,23,8,5,13,22
Anna Maria College 12575.Html,9,Cam Tobey,F,23,3,9,12,22
Anna Maria College 12575.Html,37,Samson Mouland,R,24,5,3,8,38
Anna Maria College 12575.Html,7,Nicholas Frederick,C,25,3,4,7,10
Anna Maria College 12575.Html,44,Christopher Friberg,R,17,0,7,7,2
Anna Maria College 12575.Html,19,Bryden Sinclair,D,22,2,4,6,31
Anna Maria College 12575.Html,39,Justin Taylor,D,25,1,5,6,12
Anna Maria College 12575.Html,8,Matthew Byrne,F,7,3,2,5,0
Anna Maria College 12575.Html,20,Spencer Carpenter,C,20,3,2,5,28
Anna Maria College 12575.Html,23,Giovanni Perillo,R,13,3,1,4,2
Anna Maria College 12575.Html,17,August Bouveng,C,21,1,3,4,13
Anna Maria College 12575.Html,5,Caleb Cathcart,F,18,1,2,3,10
Anna Maria College 12575.Html,22,Sean McWhinnie,F,20,0,2,2,4
Anna Maria College 12575.Html,14,Jeremy Dewar,D,19,1,0,1,2
Anna Maria College 12575.Html,30,Cole Johnston,G,7,0,1,1,2
Anna Maria College 12575.Html,16,Max Pelletier,C,10,0,1,1,8
Anna Maria College 12575.Html,2,Mkyllan Couture,D,10,0,1,1,14
Anna Maria College 12575.Html,47,Stirling Nash,F,14,0,1,1,0
Anna Maria College 12575.Html,40,Matthew Hennessey,G,17,0,1,1,0
Anna Maria College 12575.Html,31,Connor Bradford,G,3,0,0,0,0
Anna Maria College 12575.Html,11,Mark Andre,D,4,0,0,0,0
Anna Maria College 12575.Html,6,Tyler Lyewski,D,14,0,0,0,0
Arizona State University 11663.Html,61,Lukas Sillinger,L,38,11,37,48,10
Arizona State University 11663.Html,27,Timothy Lovell,D,36,5,32,37,48
Arizona State University 11663.Html,28,Matthew Kopperud,F,38,23,13,36,45
Arizona State University 11663.Html,82,Charlie Schoen,R,33,8,16,24,31
Arizona State University 11663.Html,11,Benji Eckerle,F,35,5,15,20,12
Arizona State University 11663.Html,26,Brian Chambers,F,38,4,16,20,35
Arizona State University 11663.Html,59,Tyler Gratton,R,36,12,6,18,18
Arizona State University 11663.Html,14,Ty Jackson,F,21,6,12,18,14
Arizona State University 11663.Html,25,Kyle Smolen,F,36,7,9,16,59
Arizona State University 11663.Html,39,Ryan O'Reilly,R,37,9,6,15,18
Arizona State University 11663.Html,20,Jackson Niedermayer,F,33,9,4,13,10
Arizona State University 11663.Html,9,Anthony Dowd,D,36,3,10,13,12
Arizona State University 11663.Html,15,Dylan Jackson,F,15,7,4,11,18
Arizona State University 11663.Html,53,Ryan Alexander,C,27,3,7,10,10
Arizona State University 11663.Html,2,Brandon Tabakin,D,36,2,8,10,13
Arizona State University 11663.Html,21,Alex Young,C,37,6,3,9,8
Arizona State University 11663.Html,16,Ethan Szmagaj,D,37,3,4,7,29
Arizona State University 11663.Html,5,Ty Murchison,D,37,3,4,7,62
Arizona State University 11663.Html,24,Joshua Niedermayer,D,19,0,4,4,2
Arizona State University 11663.Html,29,Cole Gordon,F,30,3,0,3,23
Arizona State University 11663.Html,89,Anthony Achille,L,12,0,3,3,7
Arizona State University 11663.Html,13,Cade Alami,D,14,0,2,2,16
Arizona State University 11663.Html,10,Tucker Ness,D,18,0,2,2,60
Arizona State University 11663.Html,43,Cole Helm,F,6,0,1,1,17
Arizona State University 11663.Html,17,Matt Romer,F,7,0,1,1,0
Arizona State University 11663.Html,35,T.J. Semptimphelter,G,26,0,1,1,2
Arizona State University 11663.Html,18,David Hymovitch,F,2,0,0,0,0
Arizona State University 11663.Html,1,Chase Hamm,G,2,0,0,0,0
Arizona State University 11663.Html,31,Gibson Homer,G,14,0,0,0,0
Army 4662.Html,23,Joey Baez,F,32,15,16,31,14
Army 4662.Html,19,Max Itagaki,F,34,6,19,25,31
Army 4662.Html,28,Brent Keefer,F,34,13,11,24,30
Army 4662.Html,2,Mac Gadowsky,D,28,4,19,23,8
Army 4662.Html,13,Michael Sacco,C,34,6,16,22,54
Army 4662.Html,4,John Driscoll,D,35,5,16,21,16
Army 4662.Html,8,Ricky Lyle,F,34,10,9,19,33
Army 4662.Html,12,Jake Hewitt,F,35,7,10,17,6
Army 4662.Html,9,Nikolas Hong,F,35,7,10,17,14
Army 4662.Html,6,Pierce Patterson,D,31,4,6,10,8
Army 4662.Html,17,Vincent Salice,F,34,4,6,10,12
Army 4662.Html,25,Barron Woodring,C,31,5,3,8,16
Army 4662.Html,16,Hunter McCoy,C,25,1,4,5,8
Army 4662.Html,22,Jude Brower,D,15,0,4,4,7
Army 4662.Html,3,Easton Zueger,D,21,1,2,3,4
Army 4662.Html,15,Lucus Kanta,F,28,1,2,3,8
Army 4662.Html,14,Owen Nolan,D,21,0,3,3,16
Army 4662.Html,20,Sean Vlasich,D,28,0,3,3,6
Army 4662.Html,24,Andrew Garby,D,10,2,0,2,2
Army 4662.Html,27,Trevor Smith,C,12,1,1,2,2
Army 4662.Html,21,Stephen Willey,F,20,1,1,2,0
Army 4662.Html,29,Eric Huss,F,15,0,1,1,4
Army 4662.Html,31,Evan Szary,G,26,0,1,1,0
Army 4662.Html,11,Josh Bohlin,C,1,0,0,0,2
Army 4662.Html,26,Joseph Dosan,F,2,0,0,0,0
Army 4662.Html,10,Jake Felker,F,14,0,0,0,19
Army 4662.Html,5,Jon Bell,D,18,0,0,0,15
Army 4662.Html,1,Gavin Abric,G,19,0,0,0,0
Army 4662.Html,7,Andrew Gilbert,D,33,0,0,0,10
Augsburg College 4690.Html,17,Erik Palmqvist,F,25,7,15,22,22
Augsburg College 4690.Html,29,Daniel Chladek,F,25,9,10,19,32
Augsburg College 4690.Html,27,Cade Stibbe,R,26,7,12,19,10
Augsburg College 4690.Html,25,Fritz Belisle,F,26,5,13,18,20
Augsburg College 4690.Html,9,Landon Parker,L,26,5,13,18,21
Augsburg College 4690.Html,22,Kyler Yeo,F,26,6,7,13,12
Augsburg College 4690.Html,19,Nick Catalano,F,25,9,3,12,2
Augsburg College 4690.Html,20,Peyton Hanson,F,26,6,6,12,6
Augsburg College 4690.Html,21,Michael Ferrandino,D,24,3,8,11,14
Augsburg College 4690.Html,11,Luke Mountain,F,26,3,6,9,12
Augsburg College 4690.Html,23,Jake Hale,C,24,2,7,9,4
Augsburg College 4690.Html,4,Gunnar Williams,D,12,1,7,8,2
Augsburg College 4690.Html,6,Logan Kons,D,26,0,8,8,14
Augsburg College 4690.Html,7,Dylan Schneider,F,25,4,2,6,2
Augsburg College 4690.Html,5,Vincent Weis,D,26,2,3,5,25
Augsburg College 4690.Html,15,Duke Kiffin,D,25,0,4,4,12
Augsburg College 4690.Html,3,Tommy Carls,F,20,3,0,3,4
Augsburg College 4690.Html,8,James Miller,D,24,0,3,3,4
Augsburg College 4690.Html,26,Blaine Warnert,F,14,1,0,1,10
Augsburg College 4690.Html,10,Konnor Carlson,L,18,1,0,1,14
Augsburg College 4690.Html,14,Jake Osiecki,D,9,0,1,1,6
Augsburg College 4690.Html,35,Samuel Vyletelka,G,26,0,1,1,0
Augsburg College 4690.Html,30,Josh Koziol,G,1,0,0,0,0
Augsburg College 4690.Html,16,Zach Carson,D,2,0,0,0,0
Augustana University 13202.Html,17,Ryan Naumovski,F,34,8,17,25,61
Augustana University 13202.Html,15,Luke Mobley,F,34,12,7,19,63
Augustana University 13202.Html,10,Arnaud Vachon,F,34,8,8,16,68
Augustana University 13202.Html,20,Uula Ruikka,D,29,5,9,14,82
Augustana University 13202.Html,9,Hayden Hennen,D,32,4,10,14,64
Augustana University 13202.Html,8,Ben Troumbly,C,28,5,8,13,31
Augustana University 13202.Html,72,Brett Meerman,F,29,3,10,13,37
Augustana University 13202.Html,81,Owen Bohn,L,31,6,6,12,51
Augustana University 13202.Html,21,Quinn Rudrud,F,29,5,7,12,53
Augustana University 13202.Html,27,Chase Brand,F,30,5,7,12,36
Augustana University 13202.Html,24,Colton Friesen,C,24,3,8,11,36
Augustana University 13202.Html,7,Evan McIntyre,D,34,3,8,11,31
Augustana University 13202.Html,22,Brady Ziemer,D,34,3,7,10,33
Augustana University 13202.Html,13,Will Howard,F,25,4,5,9,40
Augustana University 13202.Html,18,Jack Jensen,C,15,4,4,8,30
Augustana University 13202.Html,12,Hunter Bischoff,F,26,4,4,8,41
Augustana University 13202.Html,28,Shay Donovan,D,32,2,6,8,37
Augustana University 13202.Html,23,Simon Falk,F,26,0,7,7,38
Augustana University 13202.Html,26,Callum Gau,F,28,2,3,5,25
Augustana University 13202.Html,3,Anthony Stark,D,30,2,3,5,17
Augustana University 13202.Html,19,Will Svenddal,D,19,0,2,2,7
Augustana University 13202.Html,40,Zachary Rose,G,15,0,1,1,0
Augustana University 13202.Html,84,Jeff Hutchinson,D,21,0,1,1,16
Augustana University 13202.Html,29,Kayden Hargraves,G,9,0,0,0,0
Augustana University 13202.Html,32,Joshua Kotai,G,13,0,0,0,0
Augustana University 13202.Html,25,Brian Silver,D,16,0,0,0,5
Bemidji State University 10384.Html,29,Lleyton Roed,F,38,14,16,30,16
Bemidji State University 10384.Html,7,Kyle Looft,D,32,6,22,28,14
Bemidji State University 10384.Html,11,Eric Martin,R,38,8,18,26,6
Bemidji State University 10384.Html,23,Eric Pohlkamp,D,32,11,13,24,18
Bemidji State University 10384.Html,9,Carter Jones,C,37,6,18,24,12
Bemidji State University 10384.Html,19,Jackson Jutting,C,27,10,12,22,2
Bemidji State University 10384.Html,8,Adam Flammang,F,38,9,10,19,24
Bemidji State University 10384.Html,22,Austin Jouppi,F,37,2,17,19,16
Bemidji State University 10384.Html,16,Jere Vaisanen,F,37,9,8,17,4
Bemidji State University 10384.Html,20,Kirklan Irey,F,37,8,7,15,22
Bemidji State University 10384.Html,6,Mitchell Wolfe,D,38,1,12,13,14
Bemidji State University 10384.Html,28,Kasper Magnussen,L,29,7,4,11,6
Bemidji State University 10384.Html,25,Vincent Corcoran,D,34,2,9,11,14
Bemidji State University 10384.Html,27,Jake McLean,L,38,6,4,10,2
Bemidji State University 10384.Html,21,Alexander Lundman,C,20,3,5,8,4
Bemidji State University 10384.Html,18,Rhys Chiddenton,F,23,2,6,8,8
Bemidji State University 10384.Html,13,Donte Lawson,F,17,4,3,7,0
Bemidji State University 10384.Html,12,Patrik Satosaari,D,31,1,5,6,8
Bemidji State University 10384.Html,14,Liam Engstrom,R,17,3,2,5,4
Bemidji State University 10384.Html,2,Tony Follmer,D,28,1,4,5,19
Bemidji State University 10384.Html,5,William Magnuson,D,32,0,5,5,16
Bemidji State University 10384.Html,15,Logan Acheson,D,28,2,2,4,4
Bemidji State University 10384.Html,26,Jakub Lewandowski,F,9,1,1,2,4
Bemidji State University 10384.Html,17,Noah Quinn,C,18,1,0,1,10
Bemidji State University 10384.Html,35,Raythan Robbins,G,3,0,0,0,0
Bemidji State University 10384.Html,3,Jack Powell,D,4,0,0,0,0
Bemidji State University 10384.Html,1,Gavin Enright,G,15,0,0,0,0
Bemidji State University 10384.Html,30,Mattias Sholl,G,24,0,0,0,0
Boston College 4920.Html,6,William Smith,C,41,25,46,71,14
Boston College 4920.Html,19,Cutter Gauthier,L,41,38,27,65,18
Boston College 4920.Html,9,Ryan Leonard,R,41,31,29,60,38
Boston College 4920.Html,34,Gabriel Perreault,R,36,19,41,60,29
Boston College 4920.Html,21,Oskar Jellvik,L,41,13,29,42,16
Boston College 4920.Html,2,Eamon Powell,D,40,5,33,38,8
Boston College 4920.Html,24,Andre Gasseau,C,40,12,17,29,27
Boston College 4920.Html,13,Jack Malone,R,41,12,13,25,12
Boston College 4920.Html,8,Lukas Gustafsson,D,41,3,13,16,22
Boston College 4920.Html,7,Aidan Hreschuk,D,41,2,13,15,32
Boston College 4920.Html,15,Jacob Bengtsson,D,40,3,11,14,18
Boston College 4920.Html,25,Jamie Armstrong,L,32,5,7,12,17
Boston College 4920.Html,17,Aram Minnetian,D,40,3,6,9,29
Boston College 4920.Html,5,Drew Fortescue,D,40,4,4,8,36
Boston College 4920.Html,11,Colby Ambrosio,C,40,2,6,8,10
Boston College 4920.Html,12,Michael Posma,F,41,2,6,8,23
Boston College 4920.Html,22,William Vote,R,20,1,7,8,4
Boston College 4920.Html,4,Charlie Leddy,D,39,0,8,8,12
Boston College 4920.Html,27,Connor Joyce,C,35,2,4,6,6
Boston College 4920.Html,14,Gentry Shamburger,F,30,1,1,2,8
Boston College 4920.Html,1,Jacob Fowler,G,39,0,2,2,0
Boston College 4920.Html,30,Jan Korec,G,4,0,0,0,0
Boston College 4920.Html,3,Nolan Joyce,D,4,0,0,0,0
Boston College 4920.Html,23,Will Traeger,L,9,0,0,0,2
Boston University 4931.Html,71,Mack Celebrini,C,38,32,32,64,18
Boston University 4931.Html,20,Lane Hutson,D,38,15,34,49,24
Boston University 4931.Html,17,Quinn Hutson,R,40,18,18,36,35
Boston University 4931.Html,9,Ryan Greene,C,40,12,24,36,6
Boston University 4931.Html,16,Jeremy Wilmer,L,38,6,30,36,19
Boston University 4931.Html,11,Luke Tuch,F,39,10,20,30,10
Boston University 4931.Html,18,Shane LaChance,L,40,13,14,27,12
Boston University 4931.Html,5,Tom Willander,D,38,4,21,25,12
Boston University 4931.Html,21,Devin Kaplan,R,37,5,18,23,34
Boston University 4931.Html,13,Dylan Peterson,C,35,8,12,20,73
Boston University 4931.Html,27,Jack Hughes,C,38,7,12,19,12
Boston University 4931.Html,25,Sam Stevens,C,40,10,7,17,34
Boston University 4931.Html,10,Nicholas Zabaneh,F,40,8,8,16,36
Boston University 4931.Html,12,Jack Harvey,L,20,7,8,15,4
Boston University 4931.Html,7,Case McCarthy,D,39,4,5,9,10
Boston University 4931.Html,22,Aiden Celebrini,D,36,1,5,6,20
Boston University 4931.Html,8,Cade Webber,D,38,0,6,6,30
Boston University 4931.Html,2,Gavin McCarthy,D,38,1,4,5,41
Boston University 4931.Html,4,Ty Gallagher,D,37,0,5,5,14
Boston University 4931.Html,23,Doug Grimes,F,23,2,1,3,2
Boston University 4931.Html,14,"Mick ""Fitz"" Frechette",F,7,0,2,2,2
Boston University 4931.Html,29,Nick Howard,G,1,0,0,0,0
Boston University 4931.Html,33,Max Lacroix,G,1,0,0,0,0
Boston University 4931.Html,28,Thomas Jarman,D,1,0,0,0,0
Boston University 4931.Html,30,Henry Graham,G,2,0,0,0,0
Boston University 4931.Html,3,Tristan Amonte,F,8,0,0,0,0
Boston University 4931.Html,62,Mathieu Caron,G,40,0,0,0,2
Brown University 5039.Html,9,Ryan St. Louis,L,30,13,11,24,4
Brown University 5039.Html,10,Ryan Bottrill,L,30,3,16,19,10
Brown University 5039.Html,26,Max Scott,F,22,7,11,18,12
Brown University 5039.Html,11,Tyler Kopff,L,30,6,12,18,16
Brown University 5039.Html,3,Alex Pineau,D,30,7,8,15,20
Brown University 5039.Html,22,Ethan Mistry,D,30,0,11,11,6
Brown University 5039.Html,4,Brett Bliss,D,30,2,7,9,27
Brown University 5039.Html,12,Matthew Sutton,F,24,3,5,8,14
Brown University 5039.Html,27,Jordan Tonelli,C,16,3,4,7,8
Brown University 5039.Html,23,Jackson Munro,D,18,2,4,6,10
Brown University 5039.Html,8,Ryan Shostak,C,30,3,2,5,4
Brown University 5039.Html,15,Antonio Andreozzi,D,30,2,3,5,6
Brown University 5039.Html,5,Nick Traggio,D,26,3,1,4,12
Brown University 5039.Html,16,Thomas Manty,F,18,2,1,3,4
Brown University 5039.Html,17,Mike Cataldo,F,26,2,1,3,8
Brown University 5039.Html,25,Zack Tonelli,R,30,1,2,3,6
Brown University 5039.Html,24,Brendan Clark,F,16,0,3,3,14
Brown University 5039.Html,20,Noah Wakeford,F,23,0,2,2,8
Brown University 5039.Html,21,Wyatt Schlaht,L,11,1,0,1,0
Brown University 5039.Html,18,Dean Bauchiero,F,21,1,0,1,6
Brown University 5039.Html,19,Matthew Brille,F,11,0,1,1,0
Brown University 5039.Html,1,Lawton Zacher,G,26,0,1,1,0
Brown University 5039.Html,6,Harry Meirowitz,D,1,0,0,0,0
Brown University 5039.Html,14,Spencer Evans,D,9,0,0,0,0
Brown University 5039.Html,35,Tyler Shea,G,10,0,0,0,0
Brown University 5039.Html,13,Lynden Grandberg,F,18,0,0,0,0
Brown University 5039.Html,28,Gavin Puskar,F,26,0,0,0,6
Clarkson University 5265.Html,13,Mathieu Gosselin,R,31,11,17,28,35
Clarkson University 5265.Html,15,Ayrton Martino,L,31,9,18,27,8
Clarkson University 5265.Html,29,Anthony Romano,C,27,10,15,25,4
Clarkson University 5265.Html,26,Ryan Richardson,L,35,7,16,23,12
Clarkson University 5265.Html,4,Trey Taylor,D,35,4,13,17,27
Clarkson University 5265.Html,28,Ryan Taylor,F,24,10,6,16,4
Clarkson University 5265.Html,39,Eric Ciccolini,R,34,8,8,16,28
Clarkson University 5265.Html,20,Cody Monds,F,30,7,8,15,21
Clarkson University 5265.Html,17,Jesse Tucker,F,34,4,10,14,28
Clarkson University 5265.Html,5,Tristan Sarsland,D,34,5,7,12,14
Clarkson University 5265.Html,19,Ellis Rickwood,C,22,4,5,9,8
Clarkson University 5265.Html,9,Erik Bargholtz,F,29,4,5,9,6
Clarkson University 5265.Html,18,Noah Beck,D,30,3,6,9,16
Clarkson University 5265.Html,2,Jack Judson,D,35,0,7,7,57
Clarkson University 5265.Html,16,Daimon Gardner,C,29,1,5,6,8
Clarkson University 5265.Html,3,Kaelan Taylor,D,34,1,5,6,28
Clarkson University 5265.Html,27,Dustyn McFaul,D,35,3,0,3,24
Clarkson University 5265.Html,21,George Grannis,F,30,2,1,3,12
Clarkson University 5265.Html,23,Oliver Moberg,C,24,0,3,3,2
Clarkson University 5265.Html,14,Talon Sigurdson,F,25,1,1,2,10
Clarkson University 5265.Html,8,Carter Rose,D,15,1,0,1,4
Clarkson University 5265.Html,12,Caden Lewandowski,D,12,0,1,1,4
Clarkson University 5265.Html,10,Brady Egan,F,18,0,1,1,2
Clarkson University 5265.Html,33,Austin Roden,G,25,0,1,1,0
Clarkson University 5265.Html,1,Emmett Croteau,G,6,0,0,0,0
Clarkson University 5265.Html,34,Brady Parker,G,6,0,0,0,0
Clarkson University 5265.Html,11,Charlie Russell,R,7,0,0,0,0
Colby College 5290.Html,3,John McElaney,F,25,7,11,18,18
Colby College 5290.Html,20,Jack Sullivan,D,24,2,13,15,23
Colby College 5290.Html,22,Matthew MacDonald,F,24,3,10,13,6
Colby College 5290.Html,13,Henry Molson,F,25,6,6,12,8
Colby College 5290.Html,28,Tyler Crist,R,19,4,7,11,12
Colby College 5290.Html,18,Jake MacDonald,F,23,4,7,11,40
Colby College 5290.Html,4,Griffin Grise,D,25,4,7,11,14
Colby College 5290.Html,12,Jayden Grier,L,21,8,2,10,10
Colby College 5290.Html,26,Dhillon Wilde,R,19,3,7,10,6
Colby College 5290.Html,24,Nick Stapleton,F,25,3,4,7,6
Colby College 5290.Html,19,Bobby Landry,F,23,2,5,7,10
Colby College 5290.Html,8,James Tepper,F,16,6,0,6,12
Colby College 5290.Html,11,Michael McEachern,F,25,3,3,6,2
Colby College 5290.Html,17,Ryan Doolin,F,23,1,5,6,27
Colby College 5290.Html,48,Max O'Brien,D,24,0,5,5,6
Colby College 5290.Html,14,Donovan O'Neil,L,19,3,1,4,6
Colby College 5290.Html,21,Will Molson,F,19,2,2,4,4
Colby College 5290.Html,6,Javi Ubarri,D,12,2,1,3,4
Colby College 5290.Html,23,Jayden Mullens,D,21,0,3,3,2
Colby College 5290.Html,9,Max Abene,F,6,1,1,2,2
Colby College 5290.Html,7,Clay Korpi,D,19,1,1,2,4
Colby College 5290.Html,2,Daniel Juzych,D,2,1,0,1,2
Colby College 5290.Html,25,Derek Hessinger,D,5,1,0,1,2
Colby College 5290.Html,43,Reese Farrell,F,14,1,0,1,2
Colby College 5290.Html,27,Connor Gallagher,D,7,0,1,1,2
Colby College 5290.Html,16,Cody Hoban,F,1,0,0,0,0
Colby College 5290.Html,35,Edward Baliotti,G,1,0,0,0,0
Colby College 5290.Html,31,Adam Costley,G,2,0,0,0,0
Colby College 5290.Html,15,Bobby Falvey,D,4,0,0,0,2
Colby College 5290.Html,29,Ryan Moore,D,8,0,0,0,2
Colby College 5290.Html,33,Andy Beran,G,24,0,0,0,8
Colgate University 5293.Html,17,Ross Mitton,R,34,11,19,30,14
Colgate University 5293.Html,12,Daniel Panetta,C,36,13,16,29,6
Colgate University 5293.Html,29,Brett Chorske,C,35,7,20,27,6
Colgate University 5293.Html,7,Simon Labelle,L,36,7,20,27,17
Colgate University 5293.Html,19,Ryan McGuire,C,34,14,12,26,31
Colgate University 5293.Html,25,Thomas Bergsland,D,36,5,21,26,16
Colgate University 5293.Html,28,Alex DiPaolo,F,26,12,11,23,16
Colgate University 5293.Html,27,Nick Anderson,D,36,2,19,21,35
Colgate University 5293.Html,14,Ethan Manderville,C,36,9,10,19,10
Colgate University 5293.Html,24,Jake Schneider,R,35,9,9,18,12
Colgate University 5293.Html,2,Pierson Brandon,D,34,5,10,15,37
Colgate University 5293.Html,16,Ryan Sullivan,F,35,6,7,13,16
Colgate University 5293.Html,4,Reid Irwin,D,36,3,10,13,24
Colgate University 5293.Html,18,Ben Raymond,F,35,4,7,11,6
Colgate University 5293.Html,15,Dominic Foglia,D,24,2,4,6,4
Colgate University 5293.Html,20,Levi Glasman,L,33,1,5,6,6
Colgate University 5293.Html,9,Nic Belpedio,D,9,3,2,5,2
Colgate University 5293.Html,13,Sebastian Tamburro,L,13,1,4,5,4
Colgate University 5293.Html,11,Niko Rexine,R,31,2,2,4,4
Colgate University 5293.Html,6,Bobby Metz,D,36,2,2,4,2
Colgate University 5293.Html,22,Robby Newton,F,36,2,1,3,25
Colgate University 5293.Html,37,Carter Gylander,G,32,0,1,1,0
Colgate University 5293.Html,35,Nick Haas,G,1,0,0,0,0
Colgate University 5293.Html,1,Andrew Takacs,G,3,0,0,0,2
Colgate University 5293.Html,23,Owen Neuharth,F,12,0,0,0,4
Colorado College 5308.Html,26,Noah Laba,F,36,20,17,37,27
Colorado College 5308.Html,28,Gleb Veremyev,F,37,15,13,28,55
Colorado College 5308.Html,2,Zaccharya Wisdom,R,33,10,10,20,22
Colorado College 5308.Html,8,Ryan Beck,F,34,3,17,20,26
Colorado College 5308.Html,19,Evan Werner,F,37,6,13,19,10
Colorado College 5308.Html,20,Logan Will,F,37,7,11,18,12
Colorado College 5308.Html,37,Nicklas Andrews,D,37,3,14,17,29
Colorado College 5308.Html,4,Max Burkholder,D,37,7,9,16,6
Colorado College 5308.Html,7,Chase Foley,D,32,2,14,16,6
Colorado College 5308.Html,10,Bret Link,F,35,4,11,15,6
Colorado College 5308.Html,27,Stanley Cooley,F,37,5,9,14,14
Colorado College 5308.Html,5,Jack Millar,D,37,4,8,12,24
Colorado College 5308.Html,29,Drew Montgomery,F,35,5,5,10,12
Colorado College 5308.Html,24,Klavs Veinbergs,L,19,4,6,10,10
Colorado College 5308.Html,12,Thomas Middleton,F,36,4,4,8,8
Colorado College 5308.Html,11,Ray Christy,F,36,2,5,7,15
Colorado College 5308.Html,17,Tyler Coffey,L,24,5,0,5,10
Colorado College 5308.Html,23,Ethan Straky,D,37,2,3,5,16
Colorado College 5308.Html,18,Connor Mayer,D,37,0,5,5,24
Colorado College 5308.Html,25,Riley Stuart,F,19,1,2,3,11
Colorado College 5308.Html,39,Danny Weight,L,6,1,0,1,0
Colorado College 5308.Html,21,Tyler Dunbar,D,17,1,0,1,8
Colorado College 5308.Html,15,Antonio Fernandez,F,2,0,0,0,0
Colorado College 5308.Html,31,Henry Wilder,G,3,0,0,0,0
Colorado College 5308.Html,9,Noah Serdachny,C,5,0,0,0,2
Colorado College 5308.Html,30,Kaidan Mbereko,G,37,0,0,0,0
Cornell University 5347.Html,16,Gabriel Seger,F,35,14,30,44,16
Cornell University 5347.Html,17,Dalton Bancroft,F,34,12,19,31,25
Cornell University 5347.Html,22,Kyle Penney,F,35,10,18,28,18
Cornell University 5347.Html,38,Jonathan Castagna,C,35,11,14,25,25
Cornell University 5347.Html,21,Ben Robertson,D,35,5,18,23,2
Cornell University 5347.Html,14,Ryan Walsh,F,35,12,10,22,21
Cornell University 5347.Html,26,Ondrej Psenicka,F,35,9,12,21,30
Cornell University 5347.Html,19,Sullivan Mack,F,29,7,10,17,2
Cornell University 5347.Html,9,Jack O'Leary,R,35,7,8,15,12
Cornell University 5347.Html,28,Nick DeSantis,F,35,8,6,14,30
Cornell University 5347.Html,10,Jacob Kraft,F,34,4,9,13,2
Cornell University 5347.Html,5,Hoyt Stanley,D,35,2,8,10,22
Cornell University 5347.Html,12,Tim Rego,D,35,2,8,10,14
Cornell University 5347.Html,8,Luke Devlin,C,28,6,2,8,12
Cornell University 5347.Html,4,Hank Kempf,D,35,1,7,8,12
Cornell University 5347.Html,6,George Fegaras,D,33,3,4,7,12
Cornell University 5347.Html,15,Tyler Catalano,F,24,1,4,5,14
Cornell University 5347.Html,27,Michael Suda,D,32,0,5,5,10
Cornell University 5347.Html,23,Winter Wallace,F,24,1,1,2,12
Cornell University 5347.Html,18,Kyler Kovich,L,7,0,1,1,2
Cornell University 5347.Html,13,Marian Mosko,D,11,0,1,1,0
Cornell University 5347.Html,34,Ryan Mcinchak,G,1,0,0,0,0
Cornell University 5347.Html,33,Remington Keopple,G,2,0,0,0,0
Cornell University 5347.Html,3,Jack O'Brien,D,9,0,0,0,0
Cornell University 5347.Html,11,Sean Donaldson,L,10,0,0,0,0
Cornell University 5347.Html,30,Ian Shane,G,34,0,0,0,0
Dartmouth College 5416.Html,28,Luke Haymes,F,31,18,18,36,12
Dartmouth College 5416.Html,20,"Robert ""Cooper"" Flinton",L,30,15,10,25,25
Dartmouth College 5416.Html,4,C.J. Foley,D,32,5,15,20,10
Dartmouth College 5416.Html,7,Nikita Nikora,F,25,3,17,20,2
Dartmouth College 5416.Html,19,Sean Chisholm,F,28,8,9,17,11
Dartmouth College 5416.Html,17,Braiden Dorfman,F,29,8,9,17,36
Dartmouth College 5416.Html,3,John Fusco,D,32,7,10,17,19
Dartmouth College 5416.Html,8,Joey Musa,F,32,6,11,17,18
Dartmouth College 5416.Html,15,Cam MacDonald,R,31,4,9,13,8
Dartmouth College 5416.Html,2,Eric Charpentier,D,32,4,7,11,25
Dartmouth College 5416.Html,6,Matt Fusco,D,28,3,8,11,10
Dartmouth College 5416.Html,23,Ian Pierce,D,21,2,9,11,8
Dartmouth College 5416.Html,5,Tucker McRae,D,27,3,4,7,14
Dartmouth College 5416.Html,14,Steven Townley,C,32,2,4,6,10
Dartmouth College 5416.Html,68,Nathan Morgan,F,28,1,4,5,6
Dartmouth College 5416.Html,24,Oskari Vuorio,C,29,0,5,5,4
Dartmouth College 5416.Html,10,Ryan Sorkin,C,31,1,3,4,32
Dartmouth College 5416.Html,43,Owen Desilets,D,22,0,4,4,4
Dartmouth College 5416.Html,95,Alex Krause,F,18,1,1,2,15
Dartmouth College 5416.Html,22,Trym Lokkeberg,C,31,1,0,1,8
Dartmouth College 5416.Html,18,Josh Waters,L,24,0,1,1,16
Dartmouth College 5416.Html,31,Cooper Black,G,30,0,1,1,0
Dartmouth College 5416.Html,1,Mikey Roberts,G,2,0,0,0,0
Dartmouth College 5416.Html,32,Roan Clarke,G,4,0,0,0,0
Ferris State University 5732.Html,23,Antonio Venuto,F,36,12,14,26,44
Ferris State University 5732.Html,12,Luigi Benincasa,F,33,6,16,22,6
Ferris State University 5732.Html,2,Travis Shoudy,D,36,4,17,21,14
Ferris State University 5732.Html,19,Stepan Pokorny,F,36,8,10,18,26
Ferris State University 5732.Html,21,Jason Brancheau,F,35,9,7,16,16
Ferris State University 5732.Html,18,Kaleb Ergang,R,34,6,9,15,10
Ferris State University 5732.Html,27,Emerson Goode,F,32,7,5,12,24
Ferris State University 5732.Html,25,Zachary Faremouth,F,34,6,6,12,24
Ferris State University 5732.Html,15,Tyler Schleppe,C,25,3,7,10,11
Ferris State University 5732.Html,6,Jack Mesic,D,36,2,8,10,8
Ferris State University 5732.Html,28,Trevor Taulien,D,27,2,6,8,20
Ferris State University 5732.Html,22,Nick Hale,D,34,2,6,8,12
Ferris State University 5732.Html,11,Jacob Dirks,F,27,3,4,7,2
Ferris State University 5732.Html,9,Nick Nardecchia,F,34,3,4,7,27
Ferris State University 5732.Html,8,Austin McCarthy,F,20,3,2,5,4
Ferris State University 5732.Html,16,Caiden Gault,F,19,2,3,5,4
Ferris State University 5732.Html,4,Drew Cooper,D,24,2,3,5,4
Ferris State University 5732.Html,10,Holden Doell,C,24,1,3,4,12
Ferris State University 5732.Html,7,Connor McGrath,C,28,1,3,4,6
Ferris State University 5732.Html,20,Andrew Noel,D,35,1,3,4,4
Ferris State University 5732.Html,3,Ben Schultheis,D,21,0,2,2,6
Ferris State University 5732.Html,24,Brendan Maclaren,F,27,0,2,2,11
Ferris State University 5732.Html,26,Jacob Badal,F,5,0,0,0,0
Ferris State University 5732.Html,31,Noah Giesbrecht,G,18,0,0,0,0
Ferris State University 5732.Html,5,Nico DeVita,D,19,0,0,0,2
Ferris State University 5732.Html,1,Logan Stein,G,21,0,0,0,0
Gustavus Adolphus College 5959.Html,24,Drew Holt,F,25,7,11,18,2
Gustavus Adolphus College 5959.Html,16,Grant Ellings,F,25,8,8,16,18
Gustavus Adolphus College 5959.Html,28,Jack Suchy,F,24,8,7,15,15
Gustavus Adolphus College 5959.Html,22,Wilmer Svensson,C,24,7,8,15,10
Gustavus Adolphus College 5959.Html,4,Connor Mahony,F,24,7,5,12,29
Gustavus Adolphus College 5959.Html,15,Nate Stone,F,25,6,6,12,8
Gustavus Adolphus College 5959.Html,9,Jack Kubitz,D,25,1,11,12,8
Gustavus Adolphus College 5959.Html,3,Jack Anderson,D,25,3,7,10,2
Gustavus Adolphus College 5959.Html,8,Kylar Fenton,D,25,3,6,9,22
Gustavus Adolphus College 5959.Html,27,Hunter Newhouse,F,19,2,6,8,8
Gustavus Adolphus College 5959.Html,26,Artem Korolev,F,20,3,4,7,8
Gustavus Adolphus College 5959.Html,7,Jac Triemert,F,19,5,1,6,16
Gustavus Adolphus College 5959.Html,10,Joey Gimberlin,F,13,2,4,6,4
Gustavus Adolphus College 5959.Html,14,Mason Hendrickson,F,14,1,5,6,12
Gustavus Adolphus College 5959.Html,2,Marc Fletemeyer,F,12,5,0,5,6
Gustavus Adolphus College 5959.Html,19,Landon Johnson,D,19,0,4,4,12
Gustavus Adolphus College 5959.Html,11,Stanislav Danaev,F,19,2,1,3,4
Gustavus Adolphus College 5959.Html,12,Micah Gernander,F,8,1,2,3,4
Gustavus Adolphus College 5959.Html,18,Porter Haney,F,12,1,2,3,2
Gustavus Adolphus College 5959.Html,5,Luke Delzer,F,15,1,2,3,0
Gustavus Adolphus College 5959.Html,29,Brendan Sloth,D,10,1,1,2,0
Gustavus Adolphus College 5959.Html,17,Lukas Jorgensen,F,14,1,1,2,8
Gustavus Adolphus College 5959.Html,21,Christian Miller,D,24,0,2,2,4
Gustavus Adolphus College 5959.Html,20,Coby Weber,F,8,0,1,1,2
Gustavus Adolphus College 5959.Html,6,Thomas Patterer,D,9,0,1,1,0
Gustavus Adolphus College 5959.Html,1,Marko Belak,G,10,0,1,1,0
Gustavus Adolphus College 5959.Html,30,Jackson Hjelle,G,15,0,1,1,2
Gustavus Adolphus College 5959.Html,30,Zach Dosan,G,1,0,0,0,0
Gustavus Adolphus College 5959.Html,35,Will Pinney,G,3,0,0,0,0
Gustavus Adolphus College 5959.Html,13,Kyle Heffron,F,11,0,0,0,8
Hamilton College 6000.Html,27,Luke Tchor,F,26,13,21,34,14
Hamilton College 6000.Html,18,Max Bulawka,F,26,8,15,23,6
Hamilton College 6000.Html,16,James Philpott,D,26,3,16,19,6
Hamilton College 6000.Html,26,Jackson Krock,L,22,11,7,18,10
Hamilton College 6000.Html,11,Devon deVries,R,26,8,10,18,18
Hamilton College 6000.Html,25,Grisha Gotovets,F,23,8,9,17,10
Hamilton College 6000.Html,28,Justin Biraben,F,26,5,11,16,12
Hamilton College 6000.Html,23,Ben Zimmerman,F,26,5,9,14,18
Hamilton College 6000.Html,17,Alex Danis,C,22,7,3,10,6
Hamilton College 6000.Html,4,William Neault,D,24,2,6,8,5
Hamilton College 6000.Html,3,Noah Leibl,R,19,3,3,6,16
Hamilton College 6000.Html,12,Ryan Brown,C,19,2,3,5,8
Hamilton College 6000.Html,36,Lucas Constantine,D,19,0,5,5,2
Hamilton College 6000.Html,14,Logan Greene,F,25,1,3,4,6
Hamilton College 6000.Html,2,Jeremy Smith,D,15,0,4,4,8
Hamilton College 6000.Html,22,Carson Hall,F,21,0,4,4,0
Hamilton College 6000.Html,6,Ryan Sordillo,L,22,2,1,3,2
Hamilton College 6000.Html,8,Max Wutzke,D,26,2,0,2,16
Hamilton College 6000.Html,39,Vincent Gould,R,9,1,1,2,0
Hamilton College 6000.Html,24,Matthew Gellerman,F,12,1,1,2,19
Hamilton College 6000.Html,13,Cameron Miranda,D,22,0,2,2,6
Hamilton College 6000.Html,10,Nick Donaldson,F,7,0,1,1,0
Hamilton College 6000.Html,15,Bradley Holcomb,F,9,0,1,1,0
Hamilton College 6000.Html,44,Jacob Ierfino,F,14,0,1,1,6
Hamilton College 6000.Html,7,Thomas Beaudoin,F,1,0,0,0,0
Hamilton College 6000.Html,35,Joshua Nadler,G,3,0,0,0,0
Hamilton College 6000.Html,19,David Parker,D,3,0,0,0,0
Hamilton College 6000.Html,9,Brendan Waivada,F,6,0,0,0,0
Hamilton College 6000.Html,42,Charlie Archer,G,8,0,0,0,2
Hamilton College 6000.Html,34,Jack Grant,G,15,0,0,0,2
Harvard University 6047.Html,12,Joe Miller,C,32,13,14,27,8
Harvard University 6047.Html,9,Ryan Healey,D,29,9,13,22,12
Harvard University 6047.Html,21,Cameron Johnson,F,32,4,12,16,4
Harvard University 6047.Html,19,Ben MacDonald,C,32,5,10,15,36
Harvard University 6047.Html,18,Michael Callow,R,32,3,12,15,0
Harvard University 6047.Html,29,Casey Severo,F,32,8,5,13,6
Harvard University 6047.Html,8,Alex Gaffney,F,31,8,2,10,0
Harvard University 6047.Html,11,Ryan Fine,C,32,5,5,10,12
Harvard University 6047.Html,59,Zakary Karpa,C,31,4,4,8,6
Harvard University 6047.Html,2,Ian Moore,D,21,3,5,8,10
Harvard University 6047.Html,13,Marek Hejduk,R,32,5,2,7,29
Harvard University 6047.Html,7,Philip Tresca,F,16,0,7,7,6
Harvard University 6047.Html,24,Jack Bar,D,27,1,5,6,12
Harvard University 6047.Html,22,Mason Langenbrunner,D,32,0,5,5,8
Harvard University 6047.Html,23,Salvatore Guzzo,R,29,0,4,4,10
Harvard University 6047.Html,26,Ryan Drkulec,F,28,1,2,3,6
Harvard University 6047.Html,14,Matthew Morden,D,32,1,2,3,12
Harvard University 6047.Html,33,Kyle Aucoin,D,8,0,1,1,6
Harvard University 6047.Html,35,Derek Mullahy,G,17,0,1,1,0
Harvard University 6047.Html,43,Christian Jimenez,D,18,0,1,1,12
Harvard University 6047.Html,10,David Hejduk,D,22,0,1,1,8
Harvard University 6047.Html,25,Peter Frates,D,1,0,0,0,0
Harvard University 6047.Html,1,Max Miller,G,1,0,0,0,0
Harvard University 6047.Html,15,Luke Khozozian,F,12,0,0,0,19
Harvard University 6047.Html,30,Aku Koskenvuo,G,17,0,0,0,0
Harvard University 6047.Html,20,Tommy Lyons,F,29,0,0,0,2
Lake Forest College 6481.Html,11,Chase Freiermuth,F,25,14,12,26,14
Lake Forest College 6481.Html,14,Logan Kittleson,F,25,6,18,24,12
Lake Forest College 6481.Html,44,Griffen Sanom,C,23,8,11,19,46
Lake Forest College 6481.Html,10,Jared Gerger,F,25,7,7,14,22
Lake Forest College 6481.Html,5,Matteas Derraugh,D,18,2,12,14,8
Lake Forest College 6481.Html,21,Tyler Nielsen,C,25,9,3,12,18
Lake Forest College 6481.Html,9,Justin Ross,F,25,2,10,12,18
Lake Forest College 6481.Html,16,Colin Bella,F,24,8,3,11,6
Lake Forest College 6481.Html,4,Ryan Antonakis,D,20,2,9,11,10
Lake Forest College 6481.Html,24,Connor Sullivan,D,24,1,10,11,10
Lake Forest College 6481.Html,3,Connor Scahill,D,18,4,6,10,14
Lake Forest College 6481.Html,15,Tyler Buonopane,F,22,1,8,9,8
Lake Forest College 6481.Html,27,Connor Tartaglione,C,22,3,4,7,4
Lake Forest College 6481.Html,7,Ben Perkins,F,23,1,5,6,10
Lake Forest College 6481.Html,2,Fabrizio Mazzarelli,D,23,2,3,5,25
Lake Forest College 6481.Html,20,Philip Quetell,R,17,1,3,4,2
Lake Forest College 6481.Html,6,Jared Kaplowitz,D,24,0,4,4,16
Lake Forest College 6481.Html,8,Hayden Riva,F,18,3,0,3,8
Lake Forest College 6481.Html,13,Donald Borgula,R,8,0,2,2,0
Lake Forest College 6481.Html,26,Hardy Wagner,D,13,0,2,2,4
Lake Forest College 6481.Html,55,Andrew Kimball,L,10,1,0,1,15
Lake Forest College 6481.Html,29,Shane Hathaway,F,2,0,1,1,2
Lake Forest College 6481.Html,31,Alex Rohlf,G,1,0,0,0,0
Lake Forest College 6481.Html,19,Joshua Norman,F,2,0,0,0,0
Lake Forest College 6481.Html,1,Kohl Reddy,G,6,0,0,0,0
Lake Forest College 6481.Html,30,Dylan Kruss,G,8,0,0,0,2
Lake Forest College 6481.Html,17,Qaritag Kusugak-Clark,R,8,0,0,0,18
Lake Forest College 6481.Html,23,Seth Orozco,D,10,0,0,0,18
Lake Forest College 6481.Html,35,Bobby McCloskey,G,13,0,0,0,0
Lake Forest College 6481.Html,25,Andrew Nieusma,D,16,0,0,0,8
Lawrence University 6545.Html,91,Ethan Beaumont,L,27,6,14,20,52
Lawrence University 6545.Html,6,Cole Schneider,F,25,7,12,19,10
Lawrence University 6545.Html,16,Jack Michels,L,25,9,9,18,8
Lawrence University 6545.Html,72,Miles McCue,C,27,8,9,17,6
Lawrence University 6545.Html,11,Cory Checco,F,25,7,10,17,14
Lawrence University 6545.Html,15,Carter Cloutier,F,21,6,9,15,18
Lawrence University 6545.Html,2,Jayden Jensen,D,27,4,8,12,22
Lawrence University 6545.Html,18,Kyle Gierman,D,24,3,9,12,6
Lawrence University 6545.Html,40,Cody Brekke,R,27,5,5,10,30
Lawrence University 6545.Html,13,P.J. Noonan,C,19,1,7,8,12
Lawrence University 6545.Html,17,Robby Pustulka,R,17,3,4,7,10
Lawrence University 6545.Html,4,Jacob Jakusz,D,21,1,6,7,4
Lawrence University 6545.Html,23,Adam Brzezicki,R,18,4,1,5,42
Lawrence University 6545.Html,27,Oliver DeCroock,F,27,2,2,4,8
Lawrence University 6545.Html,5,Jeb Dee,D,23,1,3,4,6
Lawrence University 6545.Html,14,Will Crull,D,10,1,2,3,6
Lawrence University 6545.Html,22,Evan Izenstark,D,15,1,2,3,6
Lawrence University 6545.Html,10,Hugh Anderson,D,22,1,2,3,27
Lawrence University 6545.Html,8,Akhmed Malsagov,F,21,0,3,3,48
Lawrence University 6545.Html,12,Max Breon,F,13,1,1,2,6
Lawrence University 6545.Html,9,Brendan Vettraino,C,16,1,1,2,0
Lawrence University 6545.Html,21,Cristian Tallarico,D,10,0,2,2,8
Lawrence University 6545.Html,29,Jordan Cooper,F,15,0,2,2,15
Lawrence University 6545.Html,19,Max Wigfield,F,14,1,0,1,12
Lawrence University 6545.Html,26,Matt Ernst,D,2,0,0,0,0
Lawrence University 6545.Html,30,Ken Turelli,G,2,0,0,0,0
Lawrence University 6545.Html,7,Adam Zukowski,F,2,0,0,0,0
Lawrence University 6545.Html,20,Ryan Williams,F,3,0,0,0,0
Lawrence University 6545.Html,28,Dylan Marty,L,9,0,0,0,6
Lawrence University 6545.Html,33,Owen Carlson,G,11,0,0,0,0
Lawrence University 6545.Html,35,Nolan Mahaffey,G,21,0,0,0,0
Lindenwood University 13084.Html,19,Caige Sterzer,F,28,8,14,22,35
Lindenwood University 13084.Html,8,Kyle Jeffers,F,26,9,8,17,4
Lindenwood University 13084.Html,27,David Gagnon,F,28,8,8,16,25
Lindenwood University 13084.Html,21,Jake Southgate,L,28,7,9,16,6
Lindenwood University 13084.Html,12,Ethan Zielke,C,28,7,8,15,18
Lindenwood University 13084.Html,11,Jaeden Mercier,R,28,3,8,11,6
Lindenwood University 13084.Html,28,Kabore Dunn,D,23,0,11,11,20
Lindenwood University 13084.Html,5,Aiden Yakimchuk,D,16,5,5,10,6
Lindenwood University 13084.Html,9,Drew Kuzma,C,25,4,6,10,43
Lindenwood University 13084.Html,16,Caleb Price,D,27,4,6,10,6
Lindenwood University 13084.Html,13,Zach Aughe,F,28,3,7,10,39
Lindenwood University 13084.Html,24,Adam Conquest,F,27,3,5,8,28
Lindenwood University 13084.Html,10,Mitchell Allard,F,27,3,4,7,39
Lindenwood University 13084.Html,15,Joe Prouty,D,28,0,6,6,75
Lindenwood University 13084.Html,17,Patrick Schmiedlin,C,24,2,3,5,4
Lindenwood University 13084.Html,18,Jack Anderson,D,28,1,4,5,40
Lindenwood University 13084.Html,6,Cade Destefani,F,9,2,2,4,6
Lindenwood University 13084.Html,25,Austin Fraser,R,24,2,2,4,30
Lindenwood University 13084.Html,3,Kieran Ruscheinski,D,17,1,3,4,15
Lindenwood University 13084.Html,14,Coltan Wilkie,D,17,1,3,4,24
Lindenwood University 13084.Html,22,Brenden Rons,D,27,0,3,3,18
Lindenwood University 13084.Html,23,Shane LaVelle,F,7,1,0,1,2
Lindenwood University 13084.Html,31,Matthew Syverson,G,8,0,0,0,0
Lindenwood University 13084.Html,1,Trent Burnham,G,27,0,0,0,2
Long Island University 12796.Html,8,Isaiah Fox,F,37,14,21,35,66
Long Island University 12796.Html,13,Josh Zary,F,35,20,14,34,21
Long Island University 12796.Html,11,Chris Pappas,F,34,11,20,31,10
Long Island University 12796.Html,44,Noah Kane,F,33,8,22,30,48
Long Island University 12796.Html,6,Cade Mason,D,34,2,27,29,8
Long Island University 12796.Html,27,Remy Parker,F,35,13,6,19,6
Long Island University 12796.Html,15,Grayson Constable,R,37,9,9,18,29
Long Island University 12796.Html,21,Austin Brimmer,F,32,7,8,15,12
Long Island University 12796.Html,17,Nolan Welsh,R,32,6,9,15,21
Long Island University 12796.Html,12,Zack Nazzarett,F,19,3,9,12,4
Long Island University 12796.Html,5,Valtteri Piironen,D,31,3,9,12,18
Long Island University 12796.Html,20,Adam Pitters,F,31,4,5,9,10
Long Island University 12796.Html,19,Jack Quinn,L,34,2,6,8,31
Long Island University 12796.Html,25,Preston Brodziak,C,29,3,4,7,10
Long Island University 12796.Html,7,Jordan Di Cicco,D,33,2,5,7,4
Long Island University 12796.Html,23,Aaron Grounds,F,13,2,2,4,18
Long Island University 12796.Html,22,Riley Wallack,F,30,2,2,4,8
Long Island University 12796.Html,24,John Gormley,D,37,1,3,4,61
Long Island University 12796.Html,28,Garrett Valk,D,36,2,1,3,14
Long Island University 12796.Html,16,Xan Gurney,D,13,1,2,3,36
Long Island University 12796.Html,2,Peter Muzyka,D,35,0,3,3,70
Long Island University 12796.Html,10,Heath Armstrong,F,9,0,1,1,0
Long Island University 12796.Html,3,A.J. Casperson,D,12,0,1,1,2
Long Island University 12796.Html,35,Brandon Perrone,G,25,0,1,1,2
Long Island University 12796.Html,14,Luke Strickland,L,1,0,0,0,0
Long Island University 12796.Html,4,Atte Lehikoinen,D,7,0,0,0,2
Long Island University 12796.Html,31,Noah Rupprecht,G,8,0,0,0,0
Long Island University 12796.Html,18,Kade Peterson,F,9,0,0,0,4
Long Island University 12796.Html,33,Rico Dimatteo,G,9,0,0,0,0
Long Island University 12796.Html,9,Daniel Baldassarra,F,9,0,0,0,4
Minnesota State U   Mankato 6878.Html,6,Sam Morton,F,37,24,10,34,10
Minnesota State U   Mankato 6878.Html,21,Lucas Sowder,F,33,13,15,28,16
Minnesota State U   Mankato 6878.Html,10,Evan Murr,D,37,6,20,26,14
Minnesota State U   Mankato 6878.Html,15,Adam Eisele,F,37,8,15,23,16
Minnesota State U   Mankato 6878.Html,28,Brian Carrabes,C,36,10,12,22,6
Minnesota State U   Mankato 6878.Html,26,Kaden Bohlsen,C,37,11,10,21,52
Minnesota State U   Mankato 6878.Html,12,Josh Groll,F,34,7,13,20,15
Minnesota State U   Mankato 6878.Html,7,Luc Wilson,L,36,7,12,19,14
Minnesota State U   Mankato 6878.Html,3,Brandon Koch,D,34,1,13,14,18
Minnesota State U   Mankato 6878.Html,22,Steven Bellini,D,31,3,8,11,20
Minnesota State U   Mankato 6878.Html,23,Jordan Steinmetz,F,32,2,9,11,10
Minnesota State U   Mankato 6878.Html,4,Brett Moravec,C,27,4,4,8,10
Minnesota State U   Mankato 6878.Html,24,Zach Krajnik,F,27,1,6,7,2
Minnesota State U   Mankato 6878.Html,13,Jordan Power,D,31,1,6,7,26
Minnesota State U   Mankato 6878.Html,11,Tyler Haskins,L,18,4,2,6,2
Minnesota State U   Mankato 6878.Html,19,Will Hillman,F,36,2,3,5,12
Minnesota State U   Mankato 6878.Html,5,Mason Wheeler,D,37,1,4,5,18
Minnesota State U   Mankato 6878.Html,25,Brenden Olson,F,23,3,1,4,10
Minnesota State U   Mankato 6878.Html,20,Connor Gregga,F,28,2,2,4,8
Minnesota State U   Mankato 6878.Html,8,Campbell Cichosz,D,36,1,3,4,8
Minnesota State U   Mankato 6878.Html,27,Tony Malinowski,D,13,0,4,4,4
Minnesota State U   Mankato 6878.Html,18,Jakob Stender,D,27,0,4,4,4
Minnesota State U   Mankato 6878.Html,33,Alex Tracy,G,28,0,1,1,0
Minnesota State U   Mankato 6878.Html,32,Andrew Miller,G,1,0,0,0,0
Minnesota State U   Mankato 6878.Html,9,Tanner Edwards,F,5,0,0,0,4
Minnesota State U   Mankato 6878.Html,14,Kade Nielsen,F,8,0,0,0,0
Minnesota State U   Mankato 6878.Html,35,Keenan Rancier,G,12,0,0,0,0
