Team,Number,Name,Position,GP,G,A,PTS,PIM
Merrimack College 6794.Html,21,Matt Copponi,C,30,7,25,32,48
Merrimack College 6794.Html,37,Zach Bookman,D,33,4,24,28,30
Merrimack College 6794.Html,19,Alex Jefferies,L,22,13,10,23,19
Merrimack College 6794.Html,43,Ty Daneault,R,34,13,8,21,33
Merrimack College 6794.Html,10,Mark Hillier,L,35,7,12,19,2
Merrimack College 6794.Html,18,Ben Brar,F,35,5,14,19,20
Merrimack College 6794.Html,28,Filip Forsmark,L,35,5,13,18,25
Merrimack College 6794.Html,22,Michael Citara,F,31,6,9,15,6
Merrimack College 6794.Html,17,"Robert ""Mac"" Welsher",C,30,4,9,13,18
Merrimack College 6794.Html,23,Frank Djurasevic,D,35,4,6,10,26
Merrimack College 6794.Html,20,Ethan Bono,C,29,6,3,9,8
Merrimack College 6794.Html,8,Liam Dennison,D,35,2,7,9,10
Merrimack College 6794.Html,11,Devlin O'Brien,F,30,3,5,8,24
Merrimack College 6794.Html,2,Christian Felton,D,26,3,4,7,4
Merrimack College 6794.Html,5,Trevor Griebel,D,19,2,4,6,6
Merrimack College 6794.Html,25,Luke Weilandt,R,23,3,2,5,6
Merrimack College 6794.Html,15,Mark Gallant,F,33,2,3,5,23
Merrimack College 6794.Html,13,Chase Stevenson,F,15,4,0,4,10
Merrimack College 6794.Html,27,Adam Arvedson,D,21,1,3,4,2
Merrimack College 6794.Html,7,Max Wattvil,D,24,2,1,3,14
Merrimack College 6794.Html,26,Ivan Zivlak,D,24,1,2,3,4
Merrimack College 6794.Html,24,David Sacco,R,18,1,1,2,23
Merrimack College 6794.Html,9,Brady Hunter,C,11,0,2,2,2
Merrimack College 6794.Html,14,Tyler Young,R,12,0,1,1,25
Merrimack College 6794.Html,16,Nikita Borodayenko,F,12,0,1,1,4
Merrimack College 6794.Html,30,Steven Bacovsky,G,1,0,0,0,0
Merrimack College 6794.Html,29,Zachary Borgiel,G,16,0,0,0,2
Merrimack College 6794.Html,1,Hugo Ollas,G,22,0,0,0,2
Michigan State University 10390.Html,22,Isaac Howard,L,36,8,28,36,10
Michigan State University 10390.Html,28,Karsen Dorwart,F,38,15,20,35,28
Michigan State University 10390.Html,5,Artyom Levshunov,D,38,9,26,35,44
Michigan State University 10390.Html,18,Joey Larson,F,38,16,16,32,8
Michigan State University 10390.Html,19,Nicolas Muller,F,38,7,22,29,22
Michigan State University 10390.Html,21,Redmond Savage,C,38,10,17,27,12
Michigan State University 10390.Html,29,Gavin O'Connell,C,38,15,11,26,12
Michigan State University 10390.Html,20,Daniel Russell,F,38,13,12,25,38
Michigan State University 10390.Html,4,Nash Nienhuis,D,38,9,15,24,22
Michigan State University 10390.Html,11,Jeremy Davidson,R,38,12,10,22,28
Michigan State University 10390.Html,,Reed Lebster,R,35,6,13,19,12
Michigan State University 10390.Html,26,Tanner Kelly,F,35,9,9,18,34
Michigan State University 10390.Html,13,Tiernan Shoudy,F,38,4,12,16,26
Michigan State University 10390.Html,9,Matt Basgall,D,38,1,14,15,2
Michigan State University 10390.Html,2,Patrick Geary,D,32,5,8,13,30
Michigan State University 10390.Html,10,Tommi Mannisto,R,33,1,9,10,39
Michigan State University 10390.Html,8,Maxim Strbak,D,32,2,7,9,17
Michigan State University 10390.Html,7,David Gucciardi,D,30,2,6,8,47
Michigan State University 10390.Html,6,Austin Oravetz,D,34,0,5,5,15
Michigan State University 10390.Html,16,Owen Baker,F,7,1,1,2,15
Michigan State University 10390.Html,12,Griffin Jurecki,F,7,1,1,2,0
Michigan State University 10390.Html,3,Viktor Hurtig,D,9,1,1,2,6
Michigan State University 10390.Html,1,Trey Augustine,G,35,0,1,1,0
Michigan State University 10390.Html,27,Gavin Best,F,2,0,0,0,0
Michigan State University 10390.Html,30,Jon Mor,G,2,0,0,0,0
Michigan State University 10390.Html,31,Luca Di Pasquo,G,4,0,0,0,0
Michigan State University 10390.Html,24,James Crossman,D,6,0,0,0,0
Michigan Tech 6817.Html,16,Isaac Gordon,F,40,18,18,36,4
Michigan Tech 6817.Html,11,Ryland Mosley,L,40,18,15,33,10
Michigan Tech 6817.Html,13,Logan Pietila,R,40,13,16,29,4
Michigan Tech 6817.Html,17,Chase Pietila,D,40,3,19,22,60
Michigan Tech 6817.Html,14,Max Koskipirtti,F,33,4,17,21,10
Michigan Tech 6817.Html,29,Jack Works,F,35,10,10,20,17
Michigan Tech 6817.Html,5,Tyrone Bronte,C,35,6,8,14,23
Michigan Tech 6817.Html,25,Jed Pietila,D,40,2,12,14,26
Michigan Tech 6817.Html,20,Arvid Caderoth,F,35,7,6,13,14
Michigan Tech 6817.Html,12,Kash Rasmussen,L,35,3,9,12,9
Michigan Tech 6817.Html,9,Kyle Kukkonen,C,27,1,11,12,18
Michigan Tech 6817.Html,15,Matthew Campbell,D,30,4,7,11,8
Michigan Tech 6817.Html,22,Marcus Pedersen,R,37,5,4,9,2
Michigan Tech 6817.Html,18,Alex Nordstrom,F,26,4,4,8,6
Michigan Tech 6817.Html,21,Blais Richartz,F,31,3,4,7,8
Michigan Tech 6817.Html,8,Trevor Russell,D,38,0,7,7,30
Michigan Tech 6817.Html,4,Henry Bartle,F,16,1,4,5,19
Michigan Tech 6817.Html,19,Nick Williams,D,25,1,4,5,8
Michigan Tech 6817.Html,6,Lauri Raiman,C,32,2,2,4,4
Michigan Tech 6817.Html,10,Lachlan Getz,D,28,1,2,3,8
Michigan Tech 6817.Html,27,Austen Swankler,C,10,0,3,3,10
Michigan Tech 6817.Html,99,Patriks Marcinkevics,C,5,1,1,2,4
Michigan Tech 6817.Html,26,Evan Orr,D,14,1,1,2,2
Michigan Tech 6817.Html,28,Levi Stauber,L,20,1,1,2,4
Michigan Tech 6817.Html,7,Kasper Vaharautio,D,37,0,2,2,12
Michigan Tech 6817.Html,31,Blake Pietila,G,37,0,1,1,0
Michigan Tech 6817.Html,24,Oliver Bezick,D,1,0,0,0,0
Michigan Tech 6817.Html,35,Michael Morelli,G,1,0,0,0,0
Michigan Tech 6817.Html,23,Trevor Kukkonen,F,2,0,0,0,2
Michigan Tech 6817.Html,30,Max Vayrynen,G,4,0,0,0,0
Middlebury College 6819.Html,78,Jin Lee,C,26,10,10,20,14
Middlebury College 6819.Html,10,Andrej Hromic,F,26,8,9,17,12
Middlebury College 6819.Html,77,Wyatt Pastor,R,25,4,10,14,10
Middlebury College 6819.Html,18,Jackson Morehouse,R,24,5,7,12,6
Middlebury College 6819.Html,26,Revelin Mack,F,17,6,5,11,8
Middlebury College 6819.Html,23,Dante Palombo,F,25,4,7,11,6
Middlebury College 6819.Html,22,Andrew Seaman,R,26,2,7,9,2
Middlebury College 6819.Html,33,Paddy Mangan,D,26,2,6,8,23
Middlebury College 6819.Html,2,Bobby May,D,20,1,7,8,4
Middlebury College 6819.Html,14,Paddy Bogart,R,25,2,5,7,6
Middlebury College 6819.Html,29,Matt Myers,C,24,3,3,6,4
Middlebury College 6819.Html,19,Chris Garbe,F,26,3,2,5,8
Middlebury College 6819.Html,5,Nolan Moore,D,23,2,3,5,8
Middlebury College 6819.Html,42,John Burdett,D,25,1,4,5,24
Middlebury College 6819.Html,37,Ryan Pineault,D,19,0,5,5,16
Middlebury College 6819.Html,9,Jake Oblak,D,21,1,3,4,4
Middlebury College 6819.Html,28,Michael Fairfax,F,20,2,1,3,4
Middlebury College 6819.Html,55,Kevin Golden,D,13,1,2,3,2
Middlebury College 6819.Html,25,Tucker Lamb,R,10,1,0,1,2
Middlebury College 6819.Html,39,Zach Whitehead,F,25,1,0,1,2
Middlebury College 6819.Html,13,Zach Milton,D,14,0,1,1,2
Middlebury College 6819.Html,1,Thomas Giroux,G,1,0,0,0,0
Middlebury College 6819.Html,30,Luke Jaspan,G,2,0,0,0,0
Middlebury College 6819.Html,3,Drew Malatesta,F,3,0,0,0,0
Middlebury College 6819.Html,12,Joe Gerebi,D,4,0,0,0,0
Middlebury College 6819.Html,34,Ben Boren,F,5,0,0,0,0
Middlebury College 6819.Html,98,Max Noll,R,8,0,0,0,0
Middlebury College 6819.Html,35,Andrew Heinze,G,8,0,0,0,0
Middlebury College 6819.Html,20,Sam Amato,D,11,0,0,0,6
Middlebury College 6819.Html,31,Jake Horoho,G,21,0,0,0,0
Niagara University 7124.Html,10,Carter Randklev,F,37,11,20,31,39
Niagara University 7124.Html,18,Tyler Wallace,L,39,13,17,30,17
Niagara University 7124.Html,9,Jay Ahearn,F,34,10,16,26,26
Niagara University 7124.Html,13,Jack Richard,F,34,10,11,21,33
Niagara University 7124.Html,4,Glebs Prohorenkovs,F,39,9,12,21,21
Niagara University 7124.Html,23,Lars-Christian Rodne,F,34,8,12,20,4
Niagara University 7124.Html,21,Shane Ott,F,38,5,15,20,25
Niagara University 7124.Html,8,Luke Mylymok,L,38,9,7,16,20
Niagara University 7124.Html,11,Olivier Gauthier,L,39,4,10,14,33
Niagara University 7124.Html,26,Alex Murray,D,22,1,12,13,10
Niagara University 7124.Html,5,Noah Carlin,D,27,3,9,12,10
Niagara University 7124.Html,24,Josef Mysak,D,37,2,10,12,28
Niagara University 7124.Html,14,Connor Mylymok,L,37,6,5,11,61
Niagara University 7124.Html,2,Jonathan Ziskie,D,27,2,6,8,2
Niagara University 7124.Html,34,Noah Hackett,F,29,2,6,8,0
Niagara University 7124.Html,22,Lane Brockhoff,D,37,2,6,8,54
Niagara University 7124.Html,25,Johnny Wescoe,R,19,4,1,5,6
Niagara University 7124.Html,3,Cole Mickel,D,28,2,3,5,4
Niagara University 7124.Html,28,Ethan Lund,D,33,2,3,5,8
Niagara University 7124.Html,19,Drew Vieten,C,21,3,1,4,21
Niagara University 7124.Html,27,Aron Jessli,L,28,1,3,4,0
Niagara University 7124.Html,29,David Posma,D,15,1,2,3,2
Niagara University 7124.Html,31,Jarrett Fiske,G,29,0,3,3,0
Niagara University 7124.Html,20,Christian Gorscak,F,23,1,1,2,4
Niagara University 7124.Html,17,Max Ruoho,D,11,0,1,1,2
Niagara University 7124.Html,16,Jaedon Leslie,C,14,0,1,1,8
Niagara University 7124.Html,30,Mitchell Day,G,6,0,0,0,0
Niagara University 7124.Html,39,Ryan Ouellette,G,8,0,0,0,0
Northeastern University 7171.Html,29,Justin Hryckowian,C,32,13,30,43,8
Northeastern University 7171.Html,27,Alexander Campbell,L,36,22,20,42,6
Northeastern University 7171.Html,15,Jack Williams,F,34,17,19,36,8
Northeastern University 7171.Html,13,Dylan Hryckowian,F,34,7,27,34,22
Northeastern University 7171.Html,12,Cam Lund,C,35,11,19,30,22
Northeastern University 7171.Html,22,Vinny Borgesi,D,34,5,23,28,10
Northeastern University 7171.Html,11,Gunnarwolfe Fontaine,L,36,8,19,27,6
Northeastern University 7171.Html,4,Pito Walton,D,36,5,12,17,30
Northeastern University 7171.Html,8,Jackson Dorrington,D,33,6,6,12,6
Northeastern University 7171.Html,9,Matt Choupani,F,28,3,9,12,8
Northeastern University 7171.Html,21,Matt Demelis,C,23,2,6,8,0
Northeastern University 7171.Html,20,Brett Edwards,F,31,5,2,7,18
Northeastern University 7171.Html,14,Liam Walsh,L,36,4,3,7,28
Northeastern University 7171.Html,5,Hunter McDonald,D,23,1,5,6,32
Northeastern University 7171.Html,25,Matt Staudacher,D,31,2,2,4,8
Northeastern University 7171.Html,19,Billy Norcross,C,26,0,4,4,4
Northeastern University 7171.Html,3,Nolan Hayes,D,22,0,3,3,0
Northeastern University 7171.Html,16,Michael Fisher,D,29,1,1,2,14
Northeastern University 7171.Html,17,Braden Doyle,D,13,1,0,1,0
Northeastern University 7171.Html,18,Andy Moore,F,31,0,1,1,12
Northeastern University 7171.Html,23,Eli Sebastian,C,32,0,1,1,2
Northeastern University 7171.Html,35,Harrison Chesney,G,1,0,0,0,0
Northeastern University 7171.Html,28,Anthony Messuri,L,3,0,0,0,0
Northeastern University 7171.Html,1,Connor Hopkins,G,4,0,0,0,0
Northeastern University 7171.Html,7,Michael Outzen,F,16,0,0,0,2
Northeastern University 7171.Html,10,Patrick Dawson,D,16,0,0,0,2
Northeastern University 7171.Html,39,Cameron Whitehead,G,35,0,0,0,2
Norwich University 7183.Html,20,Clark Kerner,L,25,8,12,20,4
Norwich University 7183.Html,14,Cooper Bertrand,D,26,6,11,17,8
Norwich University 7183.Html,15,Bryan O'Mara,L,26,5,12,17,2
Norwich University 7183.Html,18,Johnny Johnson,C,26,4,12,16,6
Norwich University 7183.Html,19,Paul Schmid,F,25,7,8,15,4
Norwich University 7183.Html,9,Patrick Del Vecchio,F,22,5,7,12,4
Norwich University 7183.Html,27,Owen Sclisizzi,F,24,4,8,12,12
Norwich University 7183.Html,23,Holden Doggett,F,23,7,4,11,0
Norwich University 7183.Html,4,Devon Thibodeau,D,26,3,8,11,4
Norwich University 7183.Html,17,Patrick O'Neal,F,26,5,5,10,6
Norwich University 7183.Html,29,Jed Brazo,F,24,4,6,10,2
Norwich University 7183.Html,91,Colin Elliott,F,24,2,6,8,4
Norwich University 7183.Html,2,Nick Foster,D,21,3,3,6,7
Norwich University 7183.Html,7,Nicholas Cordeiro,F,9,2,2,4,4
Norwich University 7183.Html,22,Brady Harroun,C,10,2,2,4,2
Norwich University 7183.Html,24,Ben Van Waterschoot,F,10,2,2,4,4
Norwich University 7183.Html,12,Zach Ophoven,F,11,2,2,4,4
Norwich University 7183.Html,21,Alex Lewis,F,15,1,3,4,6
Norwich University 7183.Html,8,Joe Nagle,D,15,1,3,4,6
Norwich University 7183.Html,3,Harris Hilfiker,D,12,0,4,4,0
Norwich University 7183.Html,25,Jason Galotti,D,25,0,4,4,17
Norwich University 7183.Html,10,Michael Mackenzie,L,7,2,1,3,0
Norwich University 7183.Html,6,Matt Harvey,D,22,1,2,3,2
Norwich University 7183.Html,11,Hayden Heinrich,D,25,0,3,3,8
Norwich University 7183.Html,44,Adam Shuchart,D,7,1,1,2,6
Norwich University 7183.Html,33,Owen Hains,G,1,0,0,0,0
Norwich University 7183.Html,28,Joseph Schubert,F,2,0,0,0,0
Norwich University 7183.Html,16,Ryan Leonard,R,5,0,0,0,2
Norwich University 7183.Html,88,Bryce Walcarius,G,11,0,0,0,0
Norwich University 7183.Html,37,Sami Molu,G,15,0,0,0,2
Notre Dame 7185.Html,19,Landon Slaggert,L,36,20,11,31,10
Notre Dame 7185.Html,18,Patrick Moynihan,R,36,10,14,24,12
Notre Dame 7185.Html,11,Danny Nelson,C,30,9,14,23,32
Notre Dame 7185.Html,24,Drew Bavaro,D,35,10,10,20,38
Notre Dame 7185.Html,22,Cole Knuble,C,36,9,11,20,12
Notre Dame 7185.Html,2,Ryan Siedem,D,36,3,17,20,12
Notre Dame 7185.Html,10,Hunter Strand,C,36,4,15,19,2
Notre Dame 7185.Html,27,Trevor Janicke,C,32,9,7,16,16
Notre Dame 7185.Html,8,Justin Janicke,L,36,4,12,16,47
Notre Dame 7185.Html,16,Paul Fischer,D,34,2,14,16,30
Notre Dame 7185.Html,13,Brennan Ali,C,36,3,10,13,4
Notre Dame 7185.Html,14,Maddox Fleming,C,35,3,9,12,8
Notre Dame 7185.Html,9,Grant Silianoff,R,28,4,7,11,12
Notre Dame 7185.Html,28,Tyler Carpenter,L,33,5,4,9,16
Notre Dame 7185.Html,25,Carter Slaggert,F,32,3,4,7,24
Notre Dame 7185.Html,4,Michael Mastrodomenico,D,33,1,6,7,25
Notre Dame 7185.Html,26,Zach Plucinski,D,36,0,4,4,41
Notre Dame 7185.Html,15,Jayden Davis,F,21,2,1,3,19
Notre Dame 7185.Html,6,Jake Boltmann,D,30,0,2,2,22
Notre Dame 7185.Html,23,Brady Bjork,F,5,0,1,1,2
Notre Dame 7185.Html,12,Henry Nelson,D,31,0,1,1,42
Notre Dame 7185.Html,33,Josh Graziano,G,1,0,0,0,0
Notre Dame 7185.Html,3,Hunter Weiss,D,1,0,0,0,0
Notre Dame 7185.Html,29,Jack Williams,G,2,0,0,0,0
Notre Dame 7185.Html,17,Ryan Helliwell,D,9,0,0,0,17
Notre Dame 7185.Html,30,Ryan Bischel,G,36,0,0,0,2
Ohio State University 7241.Html,19,Stephen Halliday,C,38,10,26,36,30
Ohio State University 7241.Html,8,Scooter Brickey,D,37,13,13,26,32
Ohio State University 7241.Html,23,Davis Burnside,R,38,9,17,26,24
Ohio State University 7241.Html,44,Theo Wallberg,D,38,2,19,21,16
Ohio State University 7241.Html,16,Max Montes,F,37,9,9,18,17
Ohio State University 7241.Html,15,Cam Thiesing,F,31,9,7,16,55
Ohio State University 7241.Html,71,Patrick Guzzo,F,38,8,7,15,15
Ohio State University 7241.Html,14,Dalton Messina,L,38,6,8,14,20
Ohio State University 7241.Html,7,Brent Johnson,D,37,5,8,13,8
Ohio State University 7241.Html,10,Thomas Weis,F,37,4,7,11,33
Ohio State University 7241.Html,18,Michael Gildon,L,34,5,5,10,27
Ohio State University 7241.Html,12,Caden Brown,C,24,4,6,10,6
Ohio State University 7241.Html,21,Joseph Dunlap,F,13,3,5,8,25
Ohio State University 7241.Html,91,Jake Dunlap,F,33,3,5,8,40
Ohio State University 7241.Html,2,Nathan McBrayer,D,34,0,7,7,8
Ohio State University 7241.Html,25,Sam Deckhut,F,29,3,3,6,2
Ohio State University 7241.Html,93,Damien Carfagna,D,34,2,4,6,10
Ohio State University 7241.Html,9,Riley Hughes,R,23,1,4,5,19
Ohio State University 7241.Html,28,William Smith,D,32,1,4,5,22
Ohio State University 7241.Html,6,Mason Klee,D,38,1,4,5,25
Ohio State University 7241.Html,29,Ryan Gordon,F,30,1,2,3,4
Ohio State University 7241.Html,4,John Larkin,D,3,1,0,1,2
Ohio State University 7241.Html,34,Reilly Herbst,G,2,0,0,0,0
Ohio State University 7241.Html,60,Kristoffer Eberly,G,14,0,0,0,0
Ohio State University 7241.Html,20,Matt Cassidy,R,24,0,0,0,24
Ohio State University 7241.Html,1,Logan Terness,G,27,0,0,0,0
Pennsylvania State U 11041.Html,18,Aiden Fink,R,34,15,19,34,27
Pennsylvania State U 11041.Html,13,Daniyal Dzhaniyev,F,33,9,20,29,6
Pennsylvania State U 11041.Html,27,Jacques Bouquot,C,34,12,15,27,22
Pennsylvania State U 11041.Html,11,Ryan Kirwan,F,36,13,13,26,10
Pennsylvania State U 11041.Html,14,Matthew DiMarsico,F,35,7,19,26,18
Pennsylvania State U 11041.Html,29,Reese Laubach,C,35,10,12,22,48
Pennsylvania State U 11041.Html,4,Simon Mack,D,36,4,12,16,0
Pennsylvania State U 11041.Html,9,Xander Lamppa,F,35,3,13,16,40
Pennsylvania State U 11041.Html,22,Tanner Palocsik,D,36,2,14,16,8
Pennsylvania State U 11041.Html,16,Dylan Lugris,R,36,8,6,14,4
Pennsylvania State U 11041.Html,25,Dylan Gratton,D,36,3,10,13,2
Pennsylvania State U 11041.Html,6,Jimmy Dowd,D,28,2,11,13,26
Pennsylvania State U 11041.Html,19,Dane Dowiak,F,31,6,5,11,24
Pennsylvania State U 11041.Html,23,Tyler Paquette,R,27,6,3,9,8
Pennsylvania State U 11041.Html,24,Jarod Crespo,D,35,3,5,8,24
Pennsylvania State U 11041.Html,15,Christian Sarlo,F,25,2,6,8,2
Pennsylvania State U 11041.Html,17,Chase McLane,C,17,3,3,6,11
Pennsylvania State U 11041.Html,5,Christian Berger,D,30,2,4,6,6
Pennsylvania State U 11041.Html,8,Alex Servagno,F,30,2,4,6,2
Pennsylvania State U 11041.Html,3,Casey Aman,D,20,1,1,2,2
Pennsylvania State U 11041.Html,7,Carson Dyck,F,30,0,2,2,16
Pennsylvania State U 11041.Html,30,Doug Dorr,G,1,0,0,0,0
Pennsylvania State U 11041.Html,33,Noah Grannan,G,11,0,0,0,0
Pennsylvania State U 11041.Html,2,Carter Schade,D,21,0,0,0,15
Pennsylvania State U 11041.Html,31,Liam Souliere,G,28,0,0,0,0
Post University 12280.Html,28,Patrick Murphy,L,28,9,7,16,47
Post University 12280.Html,8,Jack Engdahl,F,30,7,9,16,6
Post University 12280.Html,3,Ryan Cardow,D,26,3,9,12,16
Post University 12280.Html,18,Connor Barter,F,26,5,6,11,58
Post University 12280.Html,14,Jake Aloi,F,26,7,3,10,4
Post University 12280.Html,11,Tommy Buis,F,30,4,5,9,10
Post University 12280.Html,10,Brandon Crowther,F,23,2,5,7,19
Post University 12280.Html,2,Cameron Craig,D,27,2,5,7,28
Post University 12280.Html,7,Michael Gethings,F,30,3,3,6,25
Post University 12280.Html,13,Parker Norling,F,30,1,5,6,22
Post University 12280.Html,15,Nick Brewer,D,30,3,2,5,42
Post University 12280.Html,24,Hugh McGuigan,F,25,2,3,5,4
Post University 12280.Html,9,Jacob Howell,F,18,1,4,5,30
Post University 12280.Html,25,Matteo Peca,C,20,1,4,5,2
Post University 12280.Html,27,Trey Deloury,D,19,0,5,5,14
Post University 12280.Html,17,Ryan Mosher,F,19,4,0,4,12
Post University 12280.Html,6,Nathan McDevitt,F,12,2,2,4,17
Post University 12280.Html,21,Conner Murray,F,26,1,2,3,21
Post University 12280.Html,22,Tanner Glasrud,D,16,1,1,2,47
Post University 12280.Html,23,Ryan O'Connell,D,26,1,1,2,12
Post University 12280.Html,16,Conner McCowell,F,14,0,2,2,0
Post University 12280.Html,5,Casey Sturgeon,D,20,0,2,2,0
Post University 12280.Html,26,Justin Harshaw,F,22,0,2,2,2
Post University 12280.Html,4,Wyatt Noble,D,28,0,2,2,8
Post University 12280.Html,35,Benjamin Cuneen,G,6,0,0,0,0
Post University 12280.Html,30,Zach Richards,G,13,0,0,0,0
Post University 12280.Html,1,Drew Blodgett,G,16,0,0,0,0
Princeton University 7557.Html,17,Adam Robbins,R,30,11,18,29,8
Princeton University 7557.Html,16,Brendan Gorman,F,29,7,17,24,19
Princeton University 7557.Html,24,David Jacobs,F,30,7,17,24,18
Princeton University 7557.Html,12,Ian Murphy,R,25,11,12,23,10
Princeton University 7557.Html,13,Nicholas Seitz,F,30,5,18,23,14
Princeton University 7557.Html,19,Jack Cronin,F,26,11,8,19,8
Princeton University 7557.Html,26,Kai Daniells,F,30,8,11,19,14
Princeton University 7557.Html,22,Noah De La Durantaye,D,29,3,15,18,6
Princeton University 7557.Html,7,Nicholas Carabin,D,27,5,12,17,26
Princeton University 7557.Html,8,Tyler Rubin,D,30,4,9,13,22
Princeton University 7557.Html,27,Jaxon Ezman,F,15,4,3,7,4
Princeton University 7557.Html,3,Mike Kennedy,D,30,2,3,5,47
Princeton University 7557.Html,18,Josh Karnish,C,27,3,1,4,28
Princeton University 7557.Html,23,Joe Berg,R,30,2,2,4,6
Princeton University 7557.Html,11,Jayden Sison,D,30,0,4,4,19
Princeton University 7557.Html,14,Carson Buydens,C,22,2,1,3,12
Princeton University 7557.Html,25,Nick Marciano,D,22,2,0,2,6
Princeton University 7557.Html,21,Michael Young,F,7,1,1,2,2
Princeton University 7557.Html,20,Kevin Anderson,R,17,1,0,1,4
Princeton University 7557.Html,6,Ian Devlin,D,12,0,1,1,8
Princeton University 7557.Html,10,Alex Konovalov,F,14,0,1,1,2
Princeton University 7557.Html,31,Ethan Pearson,G,15,0,1,1,0
Princeton University 7557.Html,28,Brendan Wang,D,25,0,1,1,8
Princeton University 7557.Html,30,Conor Callaghan,G,5,0,0,0,0
Princeton University 7557.Html,1,Arthur Smith,G,20,0,0,0,0
Princeton University 7557.Html,9,Mackenzie Merriman,L,27,0,0,0,2
Providence College 7561.Html,12,Nicholas Poisson,L,35,9,15,24,16
Providence College 7561.Html,19,Tanner Adams,R,35,6,15,21,6
Providence College 7561.Html,17,Chase Yoder,F,35,11,9,20,26
Providence College 7561.Html,9,Hudson Malinoski,C,35,9,9,18,29
Providence College 7561.Html,4,Guillaume Richard,D,35,3,15,18,27
Providence College 7561.Html,23,Bennett Schimek,R,34,8,9,17,6
Providence College 7561.Html,2,Luke Krys,D,35,6,11,17,16
Providence College 7561.Html,8,Riley Duran,C,35,9,7,16,18
Providence College 7561.Html,28,Jaroslav Chmelar,R,26,5,10,15,29
Providence College 7561.Html,11,Graham Gamache,F,35,6,8,14,8
Providence College 7561.Html,24,Austen May,D,30,4,9,13,4
Providence College 7561.Html,25,Connor Kelley,D,34,1,11,12,12
Providence College 7561.Html,18,Jamie Engelbert,F,28,7,4,11,16
Providence College 7561.Html,13,Craig Needham,L,34,4,7,11,31
Providence College 7561.Html,14,Calen Kiefiuk,L,25,2,8,10,24
Providence College 7561.Html,15,Liam Valente,C,29,4,5,9,10
Providence College 7561.Html,10,Brady Berard,C,27,2,6,8,16
Providence College 7561.Html,27,Taige Harding,D,34,2,6,8,12
Providence College 7561.Html,6,Cam McDonald,D,29,1,6,7,8
Providence College 7561.Html,20,Andrew Centrella,D,18,0,3,3,0
Providence College 7561.Html,22,Clint Levens,F,24,0,3,3,31
Providence College 7561.Html,21,Matthew Hubbarde,F,13,1,0,1,2
Providence College 7561.Html,33,Marcus Brannman,G,2,0,0,0,2
Providence College 7561.Html,35,Philip Svedeback,G,35,0,0,0,0
Quinnipiac University 7596.Html,11,Collin Graf,R,34,22,27,49,4
Quinnipiac University 7596.Html,16,Jacob Quillan,F,39,17,29,46,16
Quinnipiac University 7596.Html,20,Mason Marcellus,F,39,14,22,36,18
Quinnipiac University 7596.Html,28,Sam Lipkin,L,39,15,20,35,37
Quinnipiac University 7596.Html,27,Andon Cerbone,F,39,12,14,26,23
Quinnipiac University 7596.Html,29,Cristophe Tellier,C,39,7,19,26,12
Quinnipiac University 7596.Html,15,Jayden Lee,D,39,3,23,26,8
Quinnipiac University 7596.Html,17,Travis Treloar,F,30,12,12,24,14
Quinnipiac University 7596.Html,6,Charles-Alexis Legault,D,39,9,15,24,53
Quinnipiac University 7596.Html,4,Davis Pennington,D,39,3,21,24,14
Quinnipiac University 7596.Html,3,Cooper Moore,D,39,3,19,22,26
Quinnipiac University 7596.Html,10,Zachary Tupker,C,39,6,15,21,24
Quinnipiac University 7596.Html,13,Christophe Fillion,F,39,12,7,19,29
Quinnipiac University 7596.Html,14,Victor Czerneckianair,F,39,7,7,14,12
Quinnipiac University 7596.Html,18,Anthony Cipollone,F,36,7,6,13,2
Quinnipiac University 7596.Html,2,Iivari Rasanen,D,39,4,7,11,16
Quinnipiac University 7596.Html,24,Alex Power,F,31,4,5,9,2
Quinnipiac University 7596.Html,5,C.J. McGee,D,39,2,7,9,33
Quinnipiac University 7596.Html,8,Matthew McGroarty,C,22,1,5,6,10
Quinnipiac University 7596.Html,26,Timothy Heinke,L,6,0,1,1,0
Quinnipiac University 7596.Html,7,Jacob Martin,D,25,0,1,1,0
Quinnipiac University 7596.Html,33,Ryan Solomon,G,1,0,0,0,0
Quinnipiac University 7596.Html,12,Nick Wallace,D,2,0,0,0,0
Quinnipiac University 7596.Html,31,Noah Altman,G,3,0,0,0,0
Quinnipiac University 7596.Html,19,Chase Ramsay,D,4,0,0,0,0
Quinnipiac University 7596.Html,35,Matej Marinov,G,11,0,0,0,0
Quinnipiac University 7596.Html,37,Vincent Duplessis,G,30,0,0,0,0
R.I.T. 7599.Html,21,Carter Wilkie,F,40,16,25,41,32
R.I.T. 7599.Html,26,Cody Laskosky,F,37,14,27,41,26
R.I.T. 7599.Html,16,Elijah Gonsalves,F,36,20,18,38,30
R.I.T. 7599.Html,10,Gianfranco Cassaro,D,40,18,20,38,28
R.I.T. 7599.Html,6,Matthew Wilde,F,40,19,16,35,16
R.I.T. 7599.Html,23,Aiden Hansen-Bukata,D,37,5,26,31,28
R.I.T. 7599.Html,9,Tyler Fukakusa,F,39,9,19,28,18
R.I.T. 7599.Html,7,Tanner Andrew,C,38,6,15,21,10
R.I.T. 7599.Html,22,Grady Hobbs,F,39,10,8,18,16
R.I.T. 7599.Html,12,Simon Isabelle,C,39,8,10,18,29
R.I.T. 7599.Html,19,Christian Catalano,F,36,9,8,17,60
R.I.T. 7599.Html,14,Tyler Mahan,L,35,6,7,13,16
R.I.T. 7599.Html,11,Philippe Jacques,F,37,5,5,10,14
R.I.T. 7599.Html,5,Gustav Blom,F,32,3,7,10,20
R.I.T. 7599.Html,28,Xavier LaPointe,D,28,2,8,10,29
R.I.T. 7599.Html,4,Dimitri Mikrogiannakis,D,40,2,7,9,41
R.I.T. 7599.Html,24,Ryan Nicholson,D,40,0,9,9,22
R.I.T. 7599.Html,27,Crossley Stewart,D,30,2,6,8,23
R.I.T. 7599.Html,20,Caleb Moretz,C,39,1,5,6,8
R.I.T. 7599.Html,18,Kevin Scott,D,29,0,3,3,19
R.I.T. 7599.Html,15,Adam Jeffery,F,11,1,1,2,4
R.I.T. 7599.Html,8,Evan Miller,F,10,0,2,2,4
R.I.T. 7599.Html,32,Daniel Chenard,G,1,0,0,0,0
R.I.T. 7599.Html,33,Luke Lush,G,4,0,0,0,0
R.I.T. 7599.Html,25,Doug Scott,D,7,0,0,0,14
R.I.T. 7599.Html,30,Thomas Scarfone,G,36,0,0,0,0
R.P.I. 7600.Html,12,Austin Heidemann,C,37,11,16,27,8
R.P.I. 7600.Html,19,Sutter Muzzatti,F,33,10,15,25,79
R.P.I. 7600.Html,28,Tyler Hotson,L,37,13,9,22,32
R.P.I. 7600.Html,9,Ryan Brushett,C,37,6,15,21,14
R.P.I. 7600.Html,25,Dovar Tinling,C,34,5,12,17,43
R.P.I. 7600.Html,27,Jake Gagnon,F,30,8,6,14,8
R.P.I. 7600.Html,7,Max Smolinski,D,37,2,11,13,50
R.P.I. 7600.Html,17,John Beaton,C,32,4,8,12,2
R.P.I. 7600.Html,18,Jakob Lee,F,23,7,4,11,41
R.P.I. 7600.Html,14,John Evans,R,16,4,6,10,2
R.P.I. 7600.Html,24,Jack Brackett,L,33,1,8,9,4
R.P.I. 7600.Html,43,Brad McNeil,F,36,4,4,8,9
R.P.I. 7600.Html,3,Lauri Sertti,D,36,2,6,8,16
R.P.I. 7600.Html,8,C.J. Regula,D,29,2,5,7,22
R.P.I. 7600.Html,6,Jack Agnew,D,37,2,5,7,16
R.P.I. 7600.Html,23,Nick Strom,D,37,0,7,7,10
R.P.I. 7600.Html,2,James Goffredo,D,22,3,3,6,19
R.P.I. 7600.Html,22,Danny Ciccarello,R,25,4,1,5,6
R.P.I. 7600.Html,71,Jeremie Payant,F,19,2,2,4,10
R.P.I. 7600.Html,15,Altti Nykanen,F,7,1,3,4,0
R.P.I. 7600.Html,11,Nicolas Ardanaz,D,18,1,2,3,6
R.P.I. 7600.Html,61,Lucas Matta,D,32,1,1,2,12
R.P.I. 7600.Html,51,Finn Brown,F,16,0,1,1,0
R.P.I. 7600.Html,20,Nathan Sullivan,F,21,0,1,1,10
R.P.I. 7600.Html,10,Dylan Davies,F,3,0,0,0,2
R.P.I. 7600.Html,30,Brett Miller,G,7,0,0,0,0
R.P.I. 7600.Html,1,Carson Cherepak,G,9,0,0,0,0
R.P.I. 7600.Html,29,Brendan Budy,L,15,0,0,0,8
R.P.I. 7600.Html,34,Jack Watson,G,23,0,0,0,0
Rivier University 12939.Html,2,Damon Kiyawasew,L,23,7,12,19,10
Rivier University 12939.Html,15,Liam Hennessy,L,23,10,8,18,26
Rivier University 12939.Html,10,Cormac Hayes,F,25,7,9,16,12
Rivier University 12939.Html,13,Nicolas Paolucci,F,20,5,10,15,8
Rivier University 12939.Html,11,Jon Tavella,R,20,6,8,14,26
Rivier University 12939.Html,8,Alfred Rotiroti,R,24,7,6,13,40
Rivier University 12939.Html,18,Jack Tos,F,24,5,7,12,0
Rivier University 12939.Html,3,Carter Poulin,D,24,2,10,12,18
Rivier University 12939.Html,7,Tyler Duderstadt,D,24,3,8,11,10
Rivier University 12939.Html,37,Tyler Sitnikov,F,20,5,4,9,2
Rivier University 12939.Html,27,Hunter Phillips,F,23,4,3,7,16
Rivier University 12939.Html,26,Devon Jolley,D,24,0,6,6,10
Rivier University 12939.Html,25,Jake LaVille,F,22,3,2,5,39
Rivier University 12939.Html,22,Brett Turner,D,18,0,5,5,4
Rivier University 12939.Html,23,Ryan Nolte,F,23,2,2,4,6
Rivier University 12939.Html,9,Avery Arnold,D,25,2,2,4,14
Rivier University 12939.Html,19,Billy Hartnett,F,15,2,1,3,12
Rivier University 12939.Html,21,Bryan Van Ness,F,5,2,0,2,0
Rivier University 12939.Html,14,MacCallum Brown,D,16,0,2,2,6
Rivier University 12939.Html,17,Shawn Golden,F,13,1,0,1,2
Rivier University 12939.Html,35,Mason Meyer,G,3,0,0,0,0
Rivier University 12939.Html,30,Will Augustine,G,10,0,0,0,0
Rivier University 12939.Html,6,Alan Yu,D,13,0,0,0,8
Rivier University 12939.Html,24,Anthony Purdue,F,13,0,0,0,26
Rivier University 12939.Html,29,Luke Newell,G,14,0,0,0,2
Rivier University 12939.Html,12,Jack Sountis,D,14,0,0,0,7
Rivier University 12939.Html,28,Ashton Jones,F,20,0,0,0,0
Sacred Heart University 7803.Html,13,T.J. Walsh,L,36,13,13,26,6
Sacred Heart University 7803.Html,18,John Jaworski,F,35,10,16,26,14
Sacred Heart University 7803.Html,12,Kevin Lombardi,R,36,11,14,25,19
Sacred Heart University 7803.Html,28,Marcus Joughin,F,34,8,13,21,16
Sacred Heart University 7803.Html,6,Mikey Adamson,D,34,4,16,20,12
Sacred Heart University 7803.Html,23,Braeden Tuck,F,33,6,11,17,6
Sacred Heart University 7803.Html,8,Hunter Sansbury,D,36,5,10,15,37
Sacred Heart University 7803.Html,25,Dante Fantauzzi,D,35,2,11,13,32
Sacred Heart University 7803.Html,9,Daniel Ebrahim,L,31,9,3,12,19
Sacred Heart University 7803.Html,24,Mark Cheremeta,F,17,1,10,11,6
Sacred Heart University 7803.Html,5,Andrius Kulbis-Marino,D,36,5,5,10,14
Sacred Heart University 7803.Html,19,Jake Bongo,R,36,3,7,10,4
Sacred Heart University 7803.Html,26,Liam Izyk,F,34,4,4,8,33
Sacred Heart University 7803.Html,20,Blake Humphrey,C,23,2,4,6,4
Sacred Heart University 7803.Html,22,Conner Hutchison,D,14,1,4,5,2
Sacred Heart University 7803.Html,11,Tyler Spott,D,27,1,4,5,16
Sacred Heart University 7803.Html,4,Blake Dangos,D,19,1,3,4,16
Sacred Heart University 7803.Html,3,Grant Anderson,D,34,0,3,3,11
Sacred Heart University 7803.Html,21,Brendan Dumas,F,12,2,0,2,18
Sacred Heart University 7803.Html,10,Chikara Hanzawa,R,28,2,0,2,6
Sacred Heart University 7803.Html,27,Cole Galata,R,20,0,2,2,4
Sacred Heart University 7803.Html,29,Rylee Hlusiak,F,25,0,2,2,10
Sacred Heart University 7803.Html,16,Dylan Robbins,F,35,0,2,2,16
Sacred Heart University 7803.Html,7,Garrett Sundquist,D,9,1,0,1,2
Sacred Heart University 7803.Html,32,Chase Clark,G,19,0,1,1,0
Sacred Heart University 7803.Html,17,Aidan Connolly,F,2,0,0,0,2
Sacred Heart University 7803.Html,39,Cullen DeYoung,G,3,0,0,0,0
Sacred Heart University 7803.Html,31,Justin Robbins,G,17,0,0,0,0
St. Cloud State 8149.Html,29,Veeti Miettinen,R,37,20,15,35,0
St. Cloud State 8149.Html,4,Dylan Anhorn,D,38,6,27,33,34
St. Cloud State 8149.Html,10,Kyler Kupka,F,38,14,18,32,18
St. Cloud State 8149.Html,34,Adam Ingram,C,38,10,18,28,18
St. Cloud State 8149.Html,14,Zachary Okabe,R,38,10,14,24,21
St. Cloud State 8149.Html,19,Verner Miettinen,C,38,4,19,23,8
St. Cloud State 8149.Html,13,Tyson Gross,F,34,7,13,20,16
St. Cloud State 8149.Html,16,Mason Salquist,F,35,7,12,19,27
St. Cloud State 8149.Html,21,Josh Luedtke,D,37,4,13,17,21
St. Cloud State 8149.Html,15,Barrett Hall,C,33,8,8,16,16
St. Cloud State 8149.Html,23,Jack Peart,D,38,3,11,14,18
St. Cloud State 8149.Html,22,Joseph Molenaar,L,32,8,4,12,19
St. Cloud State 8149.Html,11,Grant Ahcan,F,23,3,5,8,15
St. Cloud State 8149.Html,17,Ethan Aucoin,F,19,4,2,6,8
St. Cloud State 8149.Html,20,Jack Rogers,F,29,4,2,6,22
St. Cloud State 8149.Html,26,Cooper Wylie,D,38,3,3,6,15
St. Cloud State 8149.Html,12,Ryan Rosborough,C,20,3,2,5,19
St. Cloud State 8149.Html,8,Tynan Ewart,D,19,0,5,5,2
St. Cloud State 8149.Html,18,Nick Portz,F,17,2,2,4,14
St. Cloud State 8149.Html,7,Jack Reimann,F,25,1,2,3,12
St. Cloud State 8149.Html,6,Mason Reiners,D,26,0,3,3,4
St. Cloud State 8149.Html,5,Warren Clark,D,31,0,3,3,8
St. Cloud State 8149.Html,2,Karl Falk,D,33,0,2,2,6
St. Cloud State 8149.Html,31,Dominic Basse,G,25,0,1,1,2
St. Cloud State 8149.Html,1,James Gray,G,1,0,0,0,0
St. Cloud State 8149.Html,27,Kaleb Tiessen,D,6,0,0,0,0
St. Cloud State 8149.Html,30,Isak Posch,G,14,0,0,0,0
St. John%27S University %28Mn%29 8182.Html,13,Jack Wandmacher,F,25,7,7,14,8
St. John%27S University %28Mn%29 8182.Html,14,Matthew DeRosa,F,22,8,5,13,6
St. John%27S University %28Mn%29 8182.Html,21,Spencer Rudrud,F,25,4,8,12,8
St. John%27S University %28Mn%29 8182.Html,11,Lewis Crosby,F,20,3,9,12,20
St. John%27S University %28Mn%29 8182.Html,20,Jackson Bisson,F,24,3,7,10,7
St. John%27S University %28Mn%29 8182.Html,9,Max Borst,F,25,3,7,10,4
St. John%27S University %28Mn%29 8182.Html,7,Cam Boche,F,24,2,7,9,8
St. John%27S University %28Mn%29 8182.Html,22,Logan Lyke,F,22,3,5,8,12
St. John%27S University %28Mn%29 8182.Html,26,Garrett Smith,F,15,4,3,7,4
St. John%27S University %28Mn%29 8182.Html,10,Mason Campbell,D,25,4,3,7,16
St. John%27S University %28Mn%29 8182.Html,27,Jack Olsen,D,25,4,3,7,2
St. John%27S University %28Mn%29 8182.Html,19,Jacob McPartland,F,21,4,2,6,2
St. John%27S University %28Mn%29 8182.Html,28,Justin Thompson,F,10,3,3,6,12
St. John%27S University %28Mn%29 8182.Html,23,Jackson Borst,C,15,3,3,6,8
St. John%27S University %28Mn%29 8182.Html,2,Parker Gnos,D,20,2,4,6,20
St. John%27S University %28Mn%29 8182.Html,24,Michael Spinner,D,18,1,5,6,12
St. John%27S University %28Mn%29 8182.Html,4,Connor Couet,D,22,1,5,6,14
St. John%27S University %28Mn%29 8182.Html,15,Cody Carlson,C,16,0,6,6,8
St. John%27S University %28Mn%29 8182.Html,18,Chris Kernan,F,15,1,4,5,6
St. John%27S University %28Mn%29 8182.Html,16,Cooper Anderson,D,20,0,5,5,10
St. John%27S University %28Mn%29 8182.Html,12,Jackson Sabo,F,17,1,1,2,20
St. John%27S University %28Mn%29 8182.Html,5,Daniel Eckerline,D,22,1,1,2,6
St. John%27S University %28Mn%29 8182.Html,3,Zach Enebak,D,10,0,2,2,4
St. John%27S University %28Mn%29 8182.Html,8,Noel Rahn,D,1,0,0,0,0
St. John%27S University %28Mn%29 8182.Html,31,Jaeger Reed,G,1,0,0,0,0
St. John%27S University %28Mn%29 8182.Html,1,Tom Kuriscak,G,2,0,0,0,0
St. John%27S University %28Mn%29 8182.Html,25,Kasen Sauer,D,3,0,0,0,0
St. John%27S University %28Mn%29 8182.Html,17,Robert Christy,L,10,0,0,0,2
St. John%27S University %28Mn%29 8182.Html,29,Bailey Huber,G,13,0,0,0,0
St. John%27S University %28Mn%29 8182.Html,30,Jon Howe,G,14,0,0,0,0
St. Lawrence University 8185.Html,25,Felikss Gavars,F,39,13,12,25,14
St. Lawrence University 8185.Html,16,Drake Burgin,D,39,7,13,20,16
St. Lawrence University 8185.Html,10,Tomas Mazura,C,34,6,14,20,12
St. Lawrence University 8185.Html,4,Mason Waite,D,39,4,16,20,14
St. Lawrence University 8185.Html,14,Justin Paul,F,37,7,12,19,10
St. Lawrence University 8185.Html,18,Tyler Cristall,F,39,7,9,16,12
St. Lawrence University 8185.Html,9,Philippe Chapleau,D,39,5,11,16,8
St. Lawrence University 8185.Html,22,Ty Naaykens,C,39,7,7,14,45
St. Lawrence University 8185.Html,34,Jan Lasak,F,35,6,7,13,2
St. Lawrence University 8185.Html,28,Joshua Boyer,F,37,3,6,9,23
St. Lawrence University 8185.Html,12,Greg Lapointe,F,25,6,2,8,6
St. Lawrence University 8185.Html,7,Luc Salem,D,38,3,5,8,30
St. Lawrence University 8185.Html,17,Reilly Moran,F,34,2,6,8,19
St. Lawrence University 8185.Html,20,Nick Trela,F,28,2,5,7,10
St. Lawrence University 8185.Html,19,Max Dorrington,F,35,2,5,7,29
St. Lawrence University 8185.Html,21,Cameron Buhl,F,26,4,2,6,6
St. Lawrence University 8185.Html,23,Jan Olenginski,D,23,3,2,5,8
St. Lawrence University 8185.Html,24,Tucker McIntosh,D,34,0,5,5,12
St. Lawrence University 8185.Html,29,Gunnar Thoreson,F,27,2,2,4,2
St. Lawrence University 8185.Html,27,Logan Ritchie,F,28,1,3,4,4
St. Lawrence University 8185.Html,11,Will Arquiett,C,30,0,3,3,12
St. Lawrence University 8185.Html,2,Anthony Mollica,D,5,0,1,1,0
St. Lawrence University 8185.Html,26,Jake Lammens,D,7,0,1,1,4
St. Lawrence University 8185.Html,15,Evan Mitchell,D,1,0,0,0,0
St. Lawrence University 8185.Html,35,Grant Adams,G,2,0,0,0,0
St. Lawrence University 8185.Html,32,Mason Kucenski,G,2,0,0,0,0
St. Lawrence University 8185.Html,8,"Isaac ""Oak"" MacLeod",R,5,0,0,0,2
St. Lawrence University 8185.Html,3,Lucas Erickson,D,14,0,0,0,10
St. Lawrence University 8185.Html,33,Benjamin Kraws,G,37,0,0,0,0
St. Norbert College 8213.Html,28,Adam Stacho,F,29,20,24,44,4
St. Norbert College 8213.Html,12,Liam Fraser,C,29,17,27,44,8
St. Norbert College 8213.Html,11,Logan Dombrowsky,D,30,14,23,37,12
St. Norbert College 8213.Html,25,T.J. Koufis,R,29,14,6,20,8
St. Norbert College 8213.Html,17,Carter Hottmann,F,30,10,10,20,8
St. Norbert College 8213.Html,9,Will Stromp,F,27,7,12,19,10
St. Norbert College 8213.Html,3,Dayton Deics,D,29,3,15,18,18
St. Norbert College 8213.Html,24,Brock Baker,L,26,4,10,14,6
St. Norbert College 8213.Html,19,Calvin Hanson,F,27,5,8,13,18
St. Norbert College 8213.Html,7,Mark Snarr,D,30,3,10,13,8
St. Norbert College 8213.Html,10,Braden Lindstrom,F,23,4,8,12,0
St. Norbert College 8213.Html,18,Curtis Hammond,R,19,5,3,8,6
St. Norbert College 8213.Html,2,Jordan Strand,D,29,1,7,8,8
St. Norbert College 8213.Html,16,Cam Morris,L,19,2,5,7,4
St. Norbert College 8213.Html,26,Gustav Portillo,R,28,1,6,7,23
St. Norbert College 8213.Html,23,Michael Black,D,16,0,7,7,8
St. Norbert College 8213.Html,5,Adam Szubert,D,26,0,7,7,4
St. Norbert College 8213.Html,21,Byron Hartley,F,21,5,1,6,17
St. Norbert College 8213.Html,22,Ian Famulak,F,23,1,5,6,2
St. Norbert College 8213.Html,27,Bryan Gilman,D,28,1,5,6,14
St. Norbert College 8213.Html,4,Ben Edwards,D,10,0,2,2,4
St. Norbert College 8213.Html,8,Jack Hillman,D,11,0,2,2,18
St. Norbert College 8213.Html,6,Cooper Morris,D,29,0,2,2,12
St. Norbert College 8213.Html,39,Hunter Garvey,G,23,0,1,1,0
St. Norbert College 8213.Html,29,John Roberts,G,7,0,0,0,0
St. Olaf College 8214.Html,20,Connor Kalthoff,D,29,6,16,22,14
St. Olaf College 8214.Html,26,Cody Sherman,L,26,7,13,20,24
St. Olaf College 8214.Html,23,Troy Bowditch,F,29,8,9,17,12
St. Olaf College 8214.Html,8,Jonathan Panisa,C,23,6,11,17,4
St. Olaf College 8214.Html,13,Jonathan Young,F,29,11,4,15,12
St. Olaf College 8214.Html,27,Noah Heisler,D,29,1,14,15,16
St. Olaf College 8214.Html,9,Joey Kennelly,F,27,5,8,13,6
St. Olaf College 8214.Html,21,Tyler Green,F,23,3,9,12,10
St. Olaf College 8214.Html,7,Sean Walsh,F,25,3,7,10,8
St. Olaf College 8214.Html,14,Tony Leahy,F,28,4,5,9,16
St. Olaf College 8214.Html,28,Tyler Cooper,F,15,5,3,8,15
St. Olaf College 8214.Html,12,Kelijah McElroy,F,28,4,4,8,2
St. Olaf College 8214.Html,18,Matthew Pointer,F,29,4,4,8,10
St. Olaf College 8214.Html,19,Parker Casey,C,29,5,2,7,20
St. Olaf College 8214.Html,3,Ben Luscko,D,27,2,5,7,16
St. Olaf College 8214.Html,16,Eric Brown,L,12,4,2,6,2
St. Olaf College 8214.Html,15,Jack Boxer,D,21,1,4,5,12
St. Olaf College 8214.Html,5,Camden Benson,D,16,3,1,4,6
St. Olaf College 8214.Html,37,Michael Webster,D,16,3,1,4,15
St. Olaf College 8214.Html,24,Kaz Matsuo,D,19,1,3,4,4
St. Olaf College 8214.Html,17,Gunnar Johnson,D,24,1,3,4,6
St. Olaf College 8214.Html,10,Luke Suter,F,3,0,4,4,0
St. Olaf College 8214.Html,11,Brendan Darby,F,12,3,0,3,2
St. Olaf College 8214.Html,4,Bjorn Lervick,D,17,1,2,3,6
St. Olaf College 8214.Html,2,Pavel Karasek,C,5,1,0,1,4
St. Olaf College 8214.Html,6,Sam Mudd,D,2,0,1,1,0
St. Olaf College 8214.Html,22,Spencer Light,F,5,0,1,1,0
St. Olaf College 8214.Html,1,Tyler Laureault,G,3,0,0,0,0
St. Olaf College 8214.Html,33,Lukas Haugen,G,13,0,0,0,0
St. Olaf College 8214.Html,29,Thomas Lalonde,G,16,0,0,0,0
St. Scholastica College 8243.Html,71,Filimon Ledenkov,F,26,7,25,32,24
St. Scholastica College 8243.Html,34,Carsen Richels,L,26,14,12,26,12
St. Scholastica College 8243.Html,11,Nathan Adrian,F,26,9,16,25,12
St. Scholastica College 8243.Html,72,Arkhip Ledenkov,F,23,9,11,20,23
St. Scholastica College 8243.Html,37,Tristan Shewchuk,C,26,9,11,20,12
St. Scholastica College 8243.Html,10,Jake Seitz,F,24,9,7,16,18
St. Scholastica College 8243.Html,23,Hunter Hanson,F,25,9,5,14,6
St. Scholastica College 8243.Html,21,Brodie Girod,C,23,8,3,11,18
St. Scholastica College 8243.Html,15,Nick Lanigan,F,25,2,9,11,20
St. Scholastica College 8243.Html,18,Bryce Johnson,F,25,2,8,10,4
St. Scholastica College 8243.Html,5,Alec Severson,D,26,1,7,8,50
St. Scholastica College 8243.Html,27,Danylo Sukhonos,D,25,0,8,8,2
St. Scholastica College 8243.Html,9,Braeden Holcomb,F,24,2,4,6,4
St. Scholastica College 8243.Html,8,Isaac Suppin,F,19,1,4,5,12
St. Scholastica College 8243.Html,29,Kieran Chung,D,9,1,3,4,2
St. Scholastica College 8243.Html,74,Sam Olson,D,25,1,2,3,6
St. Scholastica College 8243.Html,6,Matej Palfy,D,14,1,1,2,14
St. Scholastica College 8243.Html,24,Will Fisher,D,15,1,1,2,28
St. Scholastica College 8243.Html,91,Matteo Orme-Lynch,R,7,0,2,2,0
St. Scholastica College 8243.Html,7,Michael Makarenko,L,20,0,2,2,4
St. Scholastica College 8243.Html,14,Declan Young,F,7,1,0,1,0
St. Scholastica College 8243.Html,19,Alessio Raso,F,6,0,1,1,0
St. Scholastica College 8243.Html,1,Eino Rissanen,G,8,0,0,0,0
St. Scholastica College 8243.Html,17,Emmett Wurst,L,10,0,0,0,2
St. Scholastica College 8243.Html,13,Elowan Orme-Lynch,F,10,0,0,0,2
St. Scholastica College 8243.Html,31,Jack Bostedt,G,18,0,0,0,0
St. Scholastica College 8243.Html,22,Jack Fuss,D,22,0,0,0,2
Stonehill College 8269.Html,19,Frankie Ireland,L,36,9,9,18,23
Stonehill College 8269.Html,20,Henri Schreifels,F,36,8,8,16,28
Stonehill College 8269.Html,2,Greg Japchen,D,30,3,11,14,10
Stonehill College 8269.Html,25,Dean Schwenninger,F,36,4,9,13,32
Stonehill College 8269.Html,22,Jake Cady,R,26,5,4,9,25
Stonehill College 8269.Html,24,Anthony Galante,F,33,5,3,8,10
Stonehill College 8269.Html,37,Kyle Heath,F,35,1,7,8,10
Stonehill College 8269.Html,23,Justin Barker,F,24,4,3,7,10
Stonehill College 8269.Html,10,J.J. Grainda,F,22,3,4,7,10
Stonehill College 8269.Html,55,Dominick Campione,D,24,3,4,7,41
Stonehill College 8269.Html,12,Conor Ronayne,F,35,2,5,7,32
Stonehill College 8269.Html,44,William Tripp,D,25,0,7,7,21
Stonehill College 8269.Html,48,Jake LaRusso,F,19,3,2,5,10
Stonehill College 8269.Html,14,Max Pineo,F,30,3,2,5,10
Stonehill College 8269.Html,7,Cam Gaudette,D,35,1,4,5,36
Stonehill College 8269.Html,17,Matt Allen,C,22,3,1,4,25
Stonehill College 8269.Html,4,Charlie Banquier,D,16,2,2,4,28
Stonehill College 8269.Html,3,Alexander Tertyshny,D,30,0,4,4,16
Stonehill College 8269.Html,5,Ryan Davies,D,19,1,2,3,2
Stonehill College 8269.Html,21,Devon Carlstrom,D,35,0,3,3,10
Stonehill College 8269.Html,18,Nolan FitzPatrick,F,20,1,1,2,15
Stonehill College 8269.Html,77,Ryan King,L,13,1,0,1,10
Stonehill College 8269.Html,27,Cameron Collins,R,18,0,1,1,2
Stonehill College 8269.Html,30,Dylan Ghaemi,G,1,0,0,0,0
Stonehill College 8269.Html,16,Jack Shemligian,D,4,0,0,0,2
Stonehill College 8269.Html,13,Mike Martignetti,D,4,0,0,0,4
Stonehill College 8269.Html,35,Gavin Fitzpatrick,G,14,0,0,0,0
Stonehill College 8269.Html,8,Cam Mannion,D,18,0,0,0,8
Stonehill College 8269.Html,31,Dylan Meilun,G,26,0,0,0,2
Stonehill College 8269.Html,11,Hunter Hastings,R,34,0,0,0,18
Suny Canton 10573.Html,9,Evan Pringle,C,25,8,15,23,4
Suny Canton 10573.Html,88,Brendan Morrow,C,25,8,13,21,10
Suny Canton 10573.Html,18,Nic Herringer,F,25,10,9,19,8
Suny Canton 10573.Html,27,Niko Schoner,F,16,10,6,16,6
Suny Canton 10573.Html,26,Colton Sipperley,L,24,5,5,10,4
Suny Canton 10573.Html,8,Scott Cremen,D,23,2,8,10,28
Suny Canton 10573.Html,22,Reilly McKinnon,D,25,1,8,9,10
Suny Canton 10573.Html,54,Jackson Drysdale,F,18,3,5,8,29
Suny Canton 10573.Html,91,Jack Seamans,L,24,3,4,7,19
Suny Canton 10573.Html,4,Jordan Prepszl,D,19,1,6,7,4
Suny Canton 10573.Html,28,Sebastien Paquette,D,25,2,3,5,22
Suny Canton 10573.Html,15,Gino DeBlasiis,L,25,2,3,5,10
Suny Canton 10573.Html,24,Cory Liu,D,22,0,5,5,16
Suny Canton 10573.Html,16,Sam Brunton,F,16,3,1,4,0
Suny Canton 10573.Html,44,Lucas Roy,D,17,2,2,4,10
Suny Canton 10573.Html,47,Conor O'Brien,F,21,2,2,4,8
Suny Canton 10573.Html,17,Adrian Franco,C,21,1,2,3,6
Suny Canton 10573.Html,14,Trystan Mughal,L,13,0,3,3,4
Suny Canton 10573.Html,19,Bobby Voss,F,19,1,1,2,8
Suny Canton 10573.Html,29,Trey Miller,G,12,0,2,2,0
Suny Canton 10573.Html,12,Taylor Ewing,R,9,1,0,1,0
Suny Canton 10573.Html,13,Jordyn Mughal,L,19,0,1,1,8
Suny Canton 10573.Html,5,Trevor Christopher,D,20,0,1,1,16
Suny Canton 10573.Html,30,Nathaniel Hopkins,G,6,0,0,0,0
Suny Canton 10573.Html,20,Matthew Helpard,D,9,0,0,0,10
Suny Canton 10573.Html,35,Kelson Hooper,G,12,0,0,0,0
Suny Canton 10573.Html,93,Carson Cox,D,14,0,0,0,6